activitysummarydate,total_plantimmaturecount,total_planttrackedcount,total_plantfloweringcount,total_plantvegetativecount,total_plantdestroyedcount,total_plantharvestedcount,total_plantcount,salestotal,total_active_harvestcount,total_active_packagecount,total_plantbatchcount,total_activeproducts,total_activestrains,total_employees
6/4/2021 0:00,140747,225685,114894,110791,231460,966667,1423812,1658393701,1231,131289,3388,155452,30337,8334
6/3/2021 0:00,140747,225685,114894,110791,231460,966667,1423812,1658393171,1231,131271,3388,155452,30337,8334
6/2/2021 0:00,146669,221316,111723,109593,229462,961421,1412199,1651406184,1208,128029,3466,155053,30165,8282
6/1/2021 0:00,153497,211654,108947,102707,228692,960539,1400885,1648229061,1212,126709,3520,154325,30045,8282
5/31/2021 0:00,155021,210406,108882,101524,228595,959964,1398965,1645279055,1232,127630,3626,154348,30010,8274
5/30/2021 0:00,155009,210406,108882,101524,228595,959964,1398965,1645149521,1232,127706,3623,154348,30010,8274
5/29/2021 0:00,155191,209633,109335,100298,228505,958927,1397065,1638043121,1225,128933,3582,154245,29999,8274
5/28/2021 0:00,158343,206760,107354,99406,228135,958802,1393697,1635794211,1223,129220,3661,154209,29995,8270
5/27/2021 0:00,161257,204727,109002,95725,227619,954997,1387343,1631187362,1197,128357,3634,153052,29925,8263
5/26/2021 0:00,166362,202038,110580,91458,226595,949197,1377830,1625018817,1143,125482,3538,152515,29753,8234
5/25/2021 0:00,164960,202324,111459,90865,226339,948208,1376871,1623248007,1202,125190,3545,152301,29725,8233
5/24/2021 0:00,163074,202131,111097,91034,225672,946341,1374144,1620880210,1187,123684,3573,151550,29508,8212
5/23/2021 0:00,161565,201953,112520,89433,225000,943387,1370340,1616003598,1202,127179,3561,151343,29459,8143
5/22/2021 0:00,161019,202013,112088,89925,224723,943051,1369787,1611464141,1202,128128,3554,150795,29437,8146
5/21/2021 0:00,161019,202013,111958,90055,224723,943051,1369787,1611285046,1202,128109,3554,150794,29437,8146
5/20/2021 0:00,160234,200924,111588,89336,224212,942373,1367509,1606692702,1202,136927,3492,150574,29373,8112
5/19/2021 0:00,165682,194948,116598,78350,223291,935571,1353810,1600775231,1199,144942,3495,150336,29195,8061
5/18/2021 0:00,168813,192124,116835,75289,223278,935342,1350744,1600196243,1198,144988,3509,150292,29191,8061
5/17/2021 0:00,165555,193667,116348,77319,222232,931485,1347384,1597669980,1196,153592,3488,149535,29103,8018
5/16/2021 0:00,161654,189346,111889,77457,221463,930347,1341156,1592007946,1180,154018,3378,149193,29032,7973
5/15/2021 0:00,157446,187604,110441,77163,221414,929959,1338977,1587114538,1180,154778,3257,149136,29018,7954
5/14/2021 0:00,155733,188415,111553,76862,221328,928847,1338590,1585207041,1179,155033,3199,149120,29012,7964
5/13/2021 0:00,153780,186912,108295,78617,220835,928105,1335852,1580833661,1174,157057,3128,148589,28965,7941
5/12/2021 0:00,152013,185805,107183,78622,220251,924260,1330316,1576193643,1157,154600,3147,147689,28767,7901
5/11/2021 0:00,153874,184435,107317,77118,219860,921740,1326035,1573482143,1154,153556,3160,147375,28690,7877
5/10/2021 0:00,156601,182188,107552,74636,219560,920991,1322739,1572545793,1186,153341,3216,147173,28653,7850
5/9/2021 0:00,153820,180285,103824,76461,219241,919839,1319365,1570265865,1179,152777,2980,146971,28555,7847
5/8/2021 0:00,153698,181177,104363,76814,219148,919030,1319355,1565611136,1169,154014,2978,146875,28538,7846
5/7/2021 0:00,153321,177498,103905,73593,219026,918346,1314870,1558838018,1164,152912,2910,147419,28450,7834
5/6/2021 0:00,153321,177498,103905,73593,219026,918346,1314870,1558836860,1164,152876,2910,147416,28450,7834
5/5/2021 0:00,143943,177538,106491,71047,218144,913525,1309207,1552421744,1148,150044,3030,146781,28316,7783
5/4/2021 0:00,143287,177085,108470,68615,217515,910625,1305225,1549376451,1142,148299,2984,146790,28266,7757
5/3/2021 0:00,143291,177085,108470,68615,217515,910625,1305225,1549375217,1142,148256,2984,146790,28266,7757
5/2/2021 0:00,142750,180166,110295,69871,216901,906017,1303084,1543563321,1151,149096,2966,145926,28160,7748
5/1/2021 0:00,120561,180949,110862,70087,216395,905643,1302987,1538861232,1150,150262,2668,145903,28147,7749
4/30/2021 0:00,122690,180479,110186,70293,216004,904250,1300733,1534538306,1150,149311,2719,145135,28031,7748
4/29/2021 0:00,120501,181936,111532,70404,215366,901918,1299220,1531262584,1140,147938,2645,144484,27879,7704
4/28/2021 0:00,120979,181544,110879,70665,215124,899470,1296138,1528275777,1119,146592,2602,144315,27830,7709
4/27/2021 0:00,122617,177052,112731,64321,214855,896053,1287960,1525317614,1145,145328,2642,143984,27687,7695
4/26/2021 0:00,117506,177288,110386,66902,214522,894963,1286773,1522568181,1148,144581,2680,143829,27588,7694
4/25/2021 0:00,118297,176510,110399,66111,214506,894963,1285979,1522566384,1150,144712,2685,143827,27588,7693
4/24/2021 0:00,117246,177350,110584,66766,214429,894168,1285947,1515773730,1149,145944,2661,143630,27552,7689
4/23/2021 0:00,117094,177537,110584,66953,214229,894168,1285934,1513384989,1150,146216,2671,143353,27549,7688
4/22/2021 0:00,121563,174116,107671,66445,214033,893331,1281480,1510883421,1143,145439,2859,143177,27454,7691
4/21/2021 0:00,108253,171863,108422,63441,213556,890396,1275815,1507476930,1123,143605,3320,142845,27363,7643
4/20/2021 0:00,107005,171493,108869,62624,213242,887853,1272588,1504652489,1147,143344,3390,142668,27285,7635
4/19/2021 0:00,107394,168752,109154,59598,212849,887582,1269183,1500622916,1176,142244,3532,142493,27246,7607
4/18/2021 0:00,105725,170835,109822,61013,212421,884758,1268014,1497176686,1171,141578,3383,142200,27201,7580
4/17/2021 0:00,100225,171016,110748,60268,212118,883841,1266975,1488835580,1181,142438,3337,142061,27167,7583
4/16/2021 0:00,100303,171016,110748,60268,212118,883841,1266975,1487681600,1181,142578,3339,142032,27161,7583
4/15/2021 0:00,95075,170594,106782,63812,211718,883445,1265757,1484107402,1186,140835,3088,142316,27075,7571
4/14/2021 0:00,90775,169306,103398,65908,211414,882792,1263512,1480857616,1188,139372,2917,141979,26997,7550
4/13/2021 0:00,91083,171808,104360,67448,210982,877545,1260335,1477762749,1161,137883,2903,141737,26916,7524
4/12/2021 0:00,90877,171766,105118,66648,210497,873898,1256161,1472063981,1142,135558,2908,141527,26776,7492
4/11/2021 0:00,89355,172652,105889,66763,210359,873127,1256138,1471281335,1133,135567,2855,141339,26761,7488
4/10/2021 0:00,89115,173095,105965,67130,210336,872635,1256066,1468496139,1130,136455,2852,140847,26718,7483
4/9/2021 0:00,87645,173272,105602,67670,210265,872529,1256066,1464087698,1128,137083,2834,140778,26705,7480
4/8/2021 0:00,81264,171725,103687,68038,209692,870193,1251610,1456733283,1166,134135,2797,140267,26470,7459
4/7/2021 0:00,80357,171753,103687,68066,209664,870193,1251610,1456110886,1166,134042,2787,140246,26468,7459
4/6/2021 0:00,81664,169893,102254,67639,209272,868200,1247365,1453486868,1202,132356,2596,140012,26406,7458
4/5/2021 0:00,86105,169106,103469,65637,208787,864627,1242520,1447957848,1196,130944,2889,139680,26312,7431
4/4/2021 0:00,85632,169160,103026,66134,208733,863184,1241077,1447310057,1197,130626,2871,139557,26295,7426
4/3/2021 0:00,86053,169816,103708,66108,208401,862506,1240723,1445117054,1214,131187,2875,139476,26278,7425
4/2/2021 0:00,86209,170282,104330,65952,207892,862363,1240537,1440713724,1215,132381,2870,139405,26266,7435
4/1/2021 0:00,89020,170284,104193,66091,206761,857388,1234433,1432438829,1202,129950,2865,139061,26136,7433
3/31/2021 0:00,88508,170339,104192,66147,206706,857388,1234433,1431382914,1204,129970,2861,139009,26130,7433
3/30/2021 0:00,88335,169211,102604,66607,206366,855450,1231027,1428955480,1198,128024,2923,138658,26043,7483
3/29/2021 0:00,86275,167586,104618,62968,206013,853047,1226646,1424809517,1250,126838,2780,138401,25932,7471
3/28/2021 0:00,83523,166832,101978,64854,205853,852350,1225035,1423415302,1250,126331,2353,138231,25897,7437
3/27/2021 0:00,79923,168746,102045,66701,205256,849631,1223633,1415566173,1235,127616,2606,138106,25847,7431
3/26/2021 0:00,79923,168746,102045,66701,205256,849631,1223633,1415555276,1235,127613,2606,138106,25847,7431
3/25/2021 0:00,78298,169923,102695,67228,204549,846939,1221411,1411414995,1207,126276,2624,137596,25735,7409
3/24/2021 0:00,78700,167995,100977,67018,204361,846498,1218854,1407287762,1201,124357,2571,137536,25170,7394
3/23/2021 0:00,80120,164732,100399,64333,203458,845420,1213610,1403834377,1199,122878,2428,137117,24809,7395
3/22/2021 0:00,84878,161139,99139,62000,202776,842536,1206451,1399721936,1197,121659,2578,136003,24707,7369
3/21/2021 0:00,85552,161146,96874,64272,202464,841884,1205494,1396527644,1190,122291,2567,135892,24673,7365
3/20/2021 0:00,85552,161146,96874,64272,202464,841884,1205494,1395570774,1190,122643,2567,135877,24672,7366
3/19/2021 0:00,80829,161923,97200,64723,201950,839509,1203382,1387563018,1181,121830,2364,135403,24582,7312
3/18/2021 0:00,80829,161923,97200,64723,201950,839509,1203382,1387563018,1181,121827,2364,135403,24582,7309
3/17/2021 0:00,84635,162666,97123,65543,200829,833180,1196675,1380358910,1156,119131,2494,134542,24253,7273
3/16/2021 0:00,84635,162666,97123,65543,200829,833180,1196675,1380358910,1156,119066,2494,134542,24253,7273
3/15/2021 0:00,84492,162660,96859,65801,200699,830619,1193978,1377383995,1147,117690,2559,134195,24205,7260
3/14/2021 0:00,83040,164582,96907,67675,199888,829275,1193745,1248770673,1165,116718,2542,134044,24107,7288
3/13/2021 0:00,83855,164934,97744,67190,199699,828621,1193254,1247011921,1166,117100,2559,133891,24061,7293
3/12/2021 0:00,82279,164647,97681,66966,199095,828481,1192223,1244050216,1165,117866,2541,133831,24016,7293
3/11/2021 0:00,81546,165978,100599,65379,198669,825346,1189993,1240941671,1164,116127,2532,133635,23948,7283
3/10/2021 0:00,81883,166145,101569,64576,197793,822974,1186912,1239905094,1148,114778,2483,133575,23852,7267
3/9/2021 0:00,87261,166908,103168,63740,197421,819843,1184172,1239044744,1160,113667,2616,133853,23729,7211
3/8/2021 0:00,90807,164778,101706,63072,197124,818523,1180425,1237544398,1169,112169,2733,132824,23586,7190
3/7/2021 0:00,91996,164855,101809,63046,196293,817155,1178303,1236618637,1179,112164,2765,132464,23558,7174
3/6/2021 0:00,91333,165502,102502,63000,196210,816513,1178225,1235094994,1175,112800,2747,132671,23543,7174
3/5/2021 0:00,91731,167778,104934,62844,195867,814137,1177782,1232575419,1174,113076,2699,132373,23366,7164
3/4/2021 0:00,91250,164624,103463,61161,195742,813359,1173725,1230988191,1163,112514,2663,132381,23288,7153
3/3/2021 0:00,88881,162393,101665,60728,195391,812436,1170220,1230059394,1205,111004,2562,134358,23200,7134
3/2/2021 0:00,89970,161743,101912,59831,193771,811516,1167030,1229340900,1201,109929,2542,136794,23069,7099
3/1/2021 0:00,89870,161500,100068,61432,193454,809842,1164796,1227599145,1210,108728,2577,137182,22996,7055
2/28/2021 0:00,89643,162935,101582,61353,193056,807834,1163825,1226259511,1201,107880,2564,136729,22945,7046
2/27/2021 0:00,90470,162913,102358,60555,192775,807193,1162881,1224733239,1200,108994,2555,136593,22909,7046
2/26/2021 0:00,87692,163315,102638,60677,192452,807047,1162814,1221977060,1199,109631,2517,136550,22871,7046
2/25/2021 0:00,88121,165532,102147,63385,192082,804585,1162199,1220681588,1194,108654,2525,136220,22767,7029
2/24/2021 0:00,88136,164447,101334,63113,191610,802049,1158106,1219891080,1192,108230,2557,136004,22694,7008
2/23/2021 0:00,88087,163581,100066,63515,190567,799964,1154112,1219468656,1179,106505,2518,135812,22616,6997
2/22/2021 0:00,94964,165914,100775,65139,190233,797206,1153353,1218740338,1172,105282,2517,135464,22529,6983
2/21/2021 0:00,93737,168124,102066,66058,188684,794789,1151597,1218310341,1156,104365,2669,135231,22486,6973
2/20/2021 0:00,90816,168787,102346,66441,188678,794119,1151584,1217023540,1155,104768,2104,135172,22467,6971
2/19/2021 0:00,91525,168206,102566,65640,188638,793635,1150479,1214962839,1156,104867,2110,135046,22459,6966
2/18/2021 0:00,91400,168136,101320,66816,188459,792498,1149093,1214918181,1157,103486,2103,134857,22409,7021
2/17/2021 0:00,84091,165615,99539,66076,188158,790981,1144754,1215341513,1140,102356,2015,134700,22324,6986
2/16/2021 0:00,84135,163257,102004,61253,187600,788521,1139378,1215113411,1142,100900,2066,134386,22210,6974
2/15/2021 0:00,85269,164229,102082,62147,187119,786631,1137979,1214708249,1124,100185,2063,134202,22153,6963
2/14/2021 0:00,86095,163432,102850,60582,186753,785394,1135579,1213097072,1121,100099,2053,134077,22110,6967
2/13/2021 0:00,86222,164811,103915,60896,186724,784015,1135550,1210601871,1115,100540,2054,133993,22096,6968
2/12/2021 0:00,87218,164514,103121,61393,186608,783385,1134507,1207207536,1114,100852,2257,133946,22072,6962
2/11/2021 0:00,85033,163790,102117,61673,186447,783157,1133394,1204496952,1134,99585,2199,133774,22035,6966
2/10/2021 0:00,88069,161587,102387,59200,186028,780938,1128553,1203576122,1121,98860,2258,133288,21960,6958
2/9/2021 0:00,87760,162432,104158,58274,184764,778298,1125494,1202659210,1112,97190,2264,133020,21878,6928
2/8/2021 0:00,87779,161785,102337,59448,184427,777090,1123302,1202659202,1117,96276,2236,131918,21777,6916
2/7/2021 0:00,87376,163710,101100,62610,183532,774867,1122109,1202157986,1115,94948,2218,131416,21691,6882
2/6/2021 0:00,87743,164144,101033,63111,183437,774221,1121802,1202586750,1115,95395,2238,131361,21690,6874
2/5/2021 0:00,88464,162657,99698,62959,183335,774097,1120089,1198725912,1116,96067,2237,131583,21672,6873
2/4/2021 0:00,87520,160383,97988,62395,183306,772759,1116448,1195705502,1113,94617,2131,131460,21605,6862
2/3/2021 0:00,84641,160237,98254,61983,182841,770878,1113956,1192862695,1096,130760,2108,130975,21556,6850
2/2/2021 0:00,83358,158771,99240,59531,182629,767674,1109074,1191042115,1095,129487,1996,130873,21528,6830
2/1/2021 0:00,82146,160085,98078,62007,182235,765894,1108214,1189739797,1097,128888,1954,130796,21506,6817
1/31/2021 0:00,79698,160241,98378,61863,182081,764777,1107099,1189893519,1089,128330,1897,130573,21459,6796
1/30/2021 0:00,78543,160773,99079,61694,182078,764078,1106929,1188052517,1082,128889,1879,130458,21444,6793
1/29/2021 0:00,74116,160521,99280,61241,181873,763558,1105952,1185593659,1082,129419,1815,130465,21431,6788
1/28/2021 0:00,74716,160051,95959,64092,181605,762053,1103709,1183698289,1074,128020,1842,130432,21352,6784
1/27/2021 0:00,76181,162161,97118,65043,181228,758509,1101898,1182567136,1072,127064,1870,130175,21258,6744
1/26/2021 0:00,77541,162313,99263,63050,180802,756375,1099490,1181966954,1062,125903,1884,129815,21136,6729
1/25/2021 0:00,85261,156529,97820,58709,180399,754226,1091154,1181603330,1067,125330,2065,129723,21089,6715
1/24/2021 0:00,85649,155639,96460,59179,180279,752884,1088802,1181540791,1058,124282,2060,129583,21043,6689
1/23/2021 0:00,86183,155934,97182,58752,180271,752162,1088367,1181086414,1057,124731,2061,129452,21039,6684
1/22/2021 0:00,87505,154765,97026,57739,180244,751958,1086967,1179136973,1048,125913,2089,129214,21023,6679
1/21/2021 0:00,85259,156707,95797,60910,179918,749905,1086530,1177642319,1039,124509,2018,128847,20987,6683
1/20/2021 0:00,82725,154545,96433,58112,179455,747595,1081595,1177154052,1032,123410,2035,128039,20884,6679
1/19/2021 0:00,83718,151760,94218,57542,179238,746941,1077939,1175790928,1042,121915,2058,128248,20788,6665
1/18/2021 0:00,85016,153282,93564,59718,178411,743141,1074834,1175380255,1038,120527,2009,128045,20721,6653
1/17/2021 0:00,83998,155137,94001,61136,177643,741660,1074440,1174792288,1032,120500,1988,128596,20685,6646
1/16/2021 0:00,83392,155637,94061,61576,177599,740581,1073817,1173689308,1034,120838,1978,128524,20674,6644
1/15/2021 0:00,82926,155870,94007,61863,177381,740441,1073692,1171701037,1033,121641,1945,128306,20662,6635
1/14/2021 0:00,81213,155165,86837,68328,177168,739985,1072318,1170417736,1041,120904,1926,129997,20617,6627
1/13/2021 0:00,79608,157249,89030,68219,176951,736681,1070881,1170143019,1024,119647,1864,129800,20532,6614
1/12/2021 0:00,82724,156916,92669,64247,176846,732937,1066699,1169944983,1023,118691,1918,129263,20486,6644
1/11/2021 0:00,81432,154482,92370,62112,176625,732490,1063597,1169316863,1017,117480,1868,128738,20428,6643
1/10/2021 0:00,78773,152935,91482,61453,176418,731793,1061146,1168845967,1041,117440,1811,127992,20390,6642
1/9/2021 0:00,78700,153801,92337,61464,176407,730938,1061146,1167965608,1046,118046,1810,127894,20389,6639
1/8/2021 0:00,78692,153311,92449,60862,176391,730826,1060528,1165985626,1047,118405,1816,127482,20384,6685
1/7/2021 0:00,77611,152516,88407,64109,176171,729723,1058410,1164255132,1063,117612,1793,126281,20347,6676
1/6/2021 0:00,73758,151119,88124,62995,175769,729218,1056106,1163191364,1081,116306,1667,125477,20317,6666
1/5/2021 0:00,79288,146710,90195,56515,175356,726952,1049018,1162381053,1087,115141,1831,125156,20271,6657
1/4/2021 0:00,71572,147269,90892,56377,174980,724828,1047077,1161464996,1084,114376,1753,124692,20230,6391
1/3/2021 0:00,69443,148459,91047,57412,174295,722737,1045491,1160718481,1074,113636,1682,124071,20211,6365
1/2/2021 0:00,69327,148599,91190,57409,174295,722594,1045488,1160209915,1073,114313,1679,123964,20209,6365
1/1/2021 0:00,70100,147800,91126,56674,174133,722343,1044276,1158285814,1072,114688,1696,123920,20200,6368
12/31/2020 0:00,67996,146973,90859,56114,174120,722343,1043436,1158359722,1072,115341,1661,123917,20199,6388
12/30/2020 0:00,68503,146309,90785,55524,173840,720853,1041002,1156760627,1097,115206,1702,123682,20165,6386
12/29/2020 0:00,69260,146521,93354,53167,173456,718242,1038219,1155500068,1091,114789,1711,123121,20130,6378
12/28/2020 0:00,74091,145352,90617,54735,173161,714929,1033442,1153443450,1079,114259,1793,122484,20091,6383
12/27/2020 0:00,73602,146693,91078,55615,173012,712782,1032487,1150730508,1076,114493,1699,122317,20011,6352
12/26/2020 0:00,77087,145194,89126,56068,172814,712058,1030066,1148162525,1068,114927,1739,122235,20005,6351
12/25/2020 0:00,73254,144795,89256,55539,172790,711928,1029513,1144579438,1069,115807,1712,122197,19988,6348
12/24/2020 0:00,73281,144768,88254,56514,172790,711928,1029486,1144555020,1069,115809,1712,122197,19988,6348
12/23/2020 0:00,72399,145077,87542,57535,172713,710727,1028517,1141384611,1070,115594,1684,122090,19967,6317
12/22/2020 0:00,74759,143339,87551,55788,172490,708437,1024266,1137360890,1046,114526,1704,121957,19911,6252
12/21/2020 0:00,73286,145074,88101,56973,172219,705196,1022489,1133947020,1014,113102,1692,121789,19852,6261
12/20/2020 0:00,71177,146499,87610,58889,171231,703997,1021727,1131053007,1017,111980,1684,121771,19783,6277
12/19/2020 0:00,71887,146711,88306,58405,171188,703315,1021214,1128484213,1029,112760,1701,121686,19776,6275
12/18/2020 0:00,71516,146331,88477,57854,171127,703147,1020605,1124804676,1029,112745,1692,121148,19749,6275
12/17/2020 0:00,72732,141631,86433,55198,170427,702433,1014491,1121516272,1038,111795,1747,121370,19699,6237
12/16/2020 0:00,73425,140818,84643,56175,170403,702111,1013332,1120662136,1028,111883,1735,121123,19672,6230
12/15/2020 0:00,70432,142026,83715,58311,170049,699427,1011502,1117652039,1017,110783,1707,120769,19590,6215
12/14/2020 0:00,69398,144912,84225,60687,169861,696593,1011366,1114959656,1007,110001,1646,118879,19489,6206
12/13/2020 0:00,70392,142396,84663,57733,169804,695330,1007530,1112844295,1001,109100,1634,118264,19365,6201
12/12/2020 0:00,70779,142707,85389,57318,169782,694610,1007099,1110502181,994,109340,1639,118199,19360,6201
12/11/2020 0:00,70446,142924,85938,56986,169574,694501,1006999,1107089354,992,109781,1633,118158,19356,6199
12/10/2020 0:00,69173,142173,85536,56637,169468,693658,1005299,1103775283,1017,109098,1600,117561,19310,6194
12/9/2020 0:00,69635,143541,87327,56214,169203,691603,1004347,1101248103,1011,108371,1590,117124,19260,6203
12/8/2020 0:00,72396,141989,87711,54278,168834,688893,999716,1098920773,1015,107148,1642,116619,19226,6203
12/7/2020 0:00,70976,144272,87100,57172,168454,685365,998091,1096866077,1015,106345,1607,116121,19094,6185
12/6/2020 0:00,69303,143060,87362,55698,168336,684884,996280,1094855783,1038,105723,1585,115279,19070,6181
12/5/2020 0:00,69509,143866,88139,55727,168307,684107,996280,1092495529,1033,105752,1588,115211,19069,6181
12/4/2020 0:00,69525,143857,88100,55757,168305,683785,995947,1089582839,1038,106172,1604,114112,19067,6178
12/3/2020 0:00,65308,144184,88542,55642,168057,683078,995319,1086655927,1073,105512,1526,113053,19035,6177
12/2/2020 0:00,67885,145676,90026,55650,167818,680402,993896,1084191392,1100,104811,1583,112596,18966,6158
12/1/2020 0:00,69663,145639,92898,52741,167031,677419,990089,1082099167,1084,103700,1620,112253,18942,6147
11/30/2020 0:00,69244,148592,93340,55252,166539,673037,988168,1079920035,1062,103464,1618,111982,18902,6140
11/29/2020 0:00,70467,147655,93215,54440,166089,671938,985682,1078031566,1104,102830,1613,111221,18823,6128
11/28/2020 0:00,70327,148302,92292,56010,166083,671288,985673,1075862655,1082,103234,1611,111160,18818,6128
11/27/2020 0:00,68443,148461,92059,56402,165932,671140,985533,1072803841,1082,103784,1588,111094,18809,6125
11/26/2020 0:00,67532,148253,89264,58989,165694,670150,984097,1069122469,1079,103173,1517,111006,18784,6109
11/25/2020 0:00,67743,148140,89333,58807,165682,670071,983893,1068912642,1073,103249,1518,111004,18784,6108
11/24/2020 0:00,71318,144993,87606,57387,165309,668346,978648,1065200893,1116,101857,1583,110070,18730,6101
11/23/2020 0:00,69710,148044,89220,58824,164986,664929,977959,1062370278,1112,100785,1512,109750,18685,6089
11/22/2020 0:00,68491,149471,88215,61256,164813,663182,977466,1059985295,1113,100198,1497,108899,18643,6078
11/21/2020 0:00,69338,149304,87823,61481,164799,662659,976762,1057574650,1109,100412,1507,108863,18639,6075
11/20/2020 0:00,69061,148457,86138,62319,164712,662518,975687,1054196944,1109,100780,1519,108810,18629,6076
11/19/2020 0:00,71017,146168,86278,59890,164313,662030,972511,1050810360,1118,99776,1521,108458,18568,6065
11/18/2020 0:00,67459,145493,86745,58748,163968,660568,970029,1048347478,1112,98798,1473,107241,18507,6076
11/17/2020 0:00,70167,141049,87081,53968,163929,658472,963450,1046054452,1095,97781,1531,105824,18373,6050
11/16/2020 0:00,68085,141167,87200,53967,163720,657653,962540,1043998335,1093,96625,1493,104477,18185,6041
11/15/2020 0:00,76286,142189,85426,56763,163448,656359,961996,1041925026,1085,96058,1721,104141,18171,6030
11/14/2020 0:00,75877,142793,84972,57821,163393,655810,961996,1039595064,1084,96487,1720,104055,18160,6030
11/13/2020 0:00,76546,142111,84333,57778,163337,655689,961137,1036266848,1146,97070,1729,103992,18152,6029
11/12/2020 0:00,77304,141111,81088,60023,162979,655047,959137,1032904658,1136,96631,1782,103389,18129,6032
11/11/2020 0:00,76735,141878,82265,59613,162858,653168,957904,1030398653,1171,95423,1798,102413,18069,6030
11/10/2020 0:00,80952,137913,80505,57408,162741,651528,952182,1028143455,1170,95091,1970,102033,18036,6015
11/9/2020 0:00,79921,139251,78750,60501,162318,649770,951339,1026055173,1140,93967,1980,101755,17969,5998
11/8/2020 0:00,79755,139046,79239,59807,162050,648420,949516,1023985624,1137,93604,1910,100538,17908,5943
11/7/2020 0:00,81193,137870,79354,58516,161903,648305,948078,1021771687,1136,93891,1931,100515,17903,5943
11/6/2020 0:00,82329,135926,79490,56436,161848,648171,945945,1018521628,1134,94316,1951,100461,17898,5942
11/5/2020 0:00,78787,133547,79500,54047,160986,647904,942437,1015253492,1129,93440,1873,99749,17814,5936
11/4/2020 0:00,78403,133901,79326,54575,160522,646457,940880,1012946868,1077,92693,1893,99072,17774,5922
11/3/2020 0:00,80058,133770,80132,53638,160345,644643,938758,1010814544,1045,92151,1963,98202,17718,5901
11/2/2020 0:00,79401,136150,81167,54983,160043,641208,937401,1008417303,1057,91617,1962,97412,17654,5863
11/1/2020 0:00,78985,137386,83750,53636,159777,637836,934999,1006134494,1053,90927,1943,96478,17593,5859
10/31/2020 0:00,79029,138054,83248,54806,159290,637223,934567,1003671334,1038,91723,1943,96448,17588,5846
10/30/2020 0:00,79705,138075,83471,54604,159249,636579,933903,1000521905,1037,91907,1946,96397,17566,5845
10/29/2020 0:00,80566,135221,83442,51779,158966,635857,930044,997488467.9,1031,90929,2003,95930,17455,5841
10/28/2020 0:00,76150,133253,83229,50024,158624,634819,926696,994967157.9,1040,90476,1965,95295,17363,5813
10/27/2020 0:00,77571,131963,84883,47080,158274,632340,922577,992641280.6,1048,89760,1959,94562,17330,5793
10/26/2020 0:00,77304,134109,85968,48141,158030,629370,921509,990485220.5,1024,88598,1946,93832,17273,5783
10/25/2020 0:00,76401,136668,87533,49135,157786,626906,921360,988408100.9,1026,88305,1930,93724,17264,5769
10/24/2020 0:00,77719,136609,87881,48728,157714,626286,920609,985948205.1,1019,88595,1964,93621,17258,5768
10/23/2020 0:00,78611,137326,87106,50220,157503,625780,920609,982515285.7,1006,88986,1993,93592,17252,5767
10/22/2020 0:00,76483,136407,86488,49919,157246,625293,918946,979217703.3,999,87781,1906,93392,17210,5766
10/21/2020 0:00,74451,137711,87778,49933,157087,623623,918421,976696190.5,987,87381,1876,93176,17187,5765
10/20/2020 0:00,77139,136065,87047,49018,156344,621620,914029,974317730.6,980,87135,1892,92862,17154,5761
10/19/2020 0:00,76646,135930,86089,49841,156116,619733,911779,972154524.6,989,86350,1900,92436,17084,5715
10/18/2020 0:00,77376,136299,86947,49352,155865,617645,909809,970188828.8,984,85902,1995,92325,17058,5703
10/17/2020 0:00,75766,137306,87917,49389,155720,616712,909738,967629867.3,971,86195,1990,92283,16951,5703
10/16/2020 0:00,75454,137354,87610,49744,155608,616188,909150,964126686.8,975,86377,1974,92232,16947,5698
10/15/2020 0:00,75983,132851,87263,45588,155491,615965,904307,960654023.4,974,85928,1972,92044,16903,5695
10/14/2020 0:00,73243,133934,86823,47111,155106,615013,904053,958053683.2,973,85013,1950,91907,16837,5679
10/13/2020 0:00,75958,131074,83050,48024,154117,612871,898062,955812353.5,976,83986,1982,91115,16639,5675
10/12/2020 0:00,76642,129536,79462,50074,153336,611998,894870,953745499.5,967,83560,1980,90948,16569,5628
10/11/2020 0:00,76481,132258,82236,50022,153147,609036,894441,951460298.7,952,83088,1945,90583,16552,5604
10/10/2020 0:00,76852,132925,82860,50065,153058,608007,893990,948648663.1,942,83573,1948,90532,16540,5604
10/9/2020 0:00,76891,133024,82267,50757,152883,607579,893486,945013877.7,937,83913,1957,90491,16538,5602
10/8/2020 0:00,75992,134044,81530,52514,152661,606572,893277,941674795.5,922,83166,1925,89528,16523,5592
10/7/2020 0:00,74977,134709,82541,52168,152513,604905,892127,938944752.1,928,82582,1867,89305,16460,5571
10/6/2020 0:00,80286,133143,84901,48242,151699,602266,887108,936703403.6,907,81988,2010,89592,16406,5564
10/5/2020 0:00,79572,135973,86418,49555,151454,598818,886245,934493702,895,81290,2002,89335,16379,5553
10/4/2020 0:00,75366,137418,86839,50579,150345,596721,884484,932328988.6,885,80626,1874,88992,16339,5529
10/3/2020 0:00,75122,137692,86678,51014,150303,596333,884328,929838400.8,882,81169,1850,88937,16338,5526
10/2/2020 0:00,76217,136949,84721,52228,150218,595665,882832,926427635.3,857,81396,1865,88887,16334,5495
10/1/2020 0:00,79333,134603,81189,53414,150076,595168,879847,923018937.7,847,80613,1873,88398,16284,5484
9/30/2020 0:00,79830,133648,81150,52498,149748,593537,876933,920308703,843,80358,1873,87514,16234,5470
9/29/2020 0:00,81420,134000,82539,51461,149426,590226,873652,917940577.4,845,79848,2058,87358,16209,5451
9/28/2020 0:00,78637,135337,80515,54822,148993,589310,873640,915720895.5,849,79016,2004,87203,16181,5439
9/27/2020 0:00,79575,135590,82117,53473,148847,587259,871696,913340451.5,838,78324,2069,87007,16100,5440
9/26/2020 0:00,79279,134549,80327,54222,148782,586746,870077,910836716.3,833,78900,2059,86950,16081,5439
9/25/2020 0:00,79957,133428,80711,52717,148613,586622,868663,907537019.6,833,79250,2096,86844,16064,5438
9/24/2020 0:00,80054,133801,80027,53774,148371,584965,867137,904212702.8,830,78686,2056,86699,15978,5425
9/23/2020 0:00,81532,132391,78185,54206,148167,583228,863786,901653108.8,817,77967,2164,86431,15927,5374
9/22/2020 0:00,83009,131175,79745,51430,147864,580723,859762,899282305.5,826,77327,2175,85996,15851,5362
9/21/2020 0:00,78870,134032,80029,54003,147501,577956,859489,897075825.3,808,76755,2065,85825,15815,5373
9/20/2020 0:00,78499,135802,77161,58641,147353,575345,858500,894868122.7,796,76449,2070,85622,15804,5365
9/19/2020 0:00,78030,136310,78034,58276,147301,574358,857969,892250922.9,787,76835,2081,85568,15792,5365
9/18/2020 0:00,79832,134807,78135,56672,147064,574220,856091,888737302.2,784,77098,2079,85486,15779,5365
9/17/2020 0:00,79432,136680,79418,57262,146422,572589,855691,885226963.7,780,76957,2109,85318,15744,5356
9/16/2020 0:00,75348,135067,78692,56375,146199,571370,852636,882530671.4,784,76064,2071,85189,15725,5342
9/15/2020 0:00,74045,134205,78575,55630,145973,569897,850075,880262880.6,768,75206,1951,84995,15638,5322
9/14/2020 0:00,74061,133834,78060,55774,145388,568885,848107,877895678.9,770,74817,1913,84843,15617,5333
9/13/2020 0:00,74453,133122,78576,54546,144932,567616,845670,875601699.3,765,74631,1898,84780,15592,5306
9/12/2020 0:00,75897,134297,79694,54603,144896,566458,845651,873287702.9,748,74751,1928,84749,15589,5306
9/11/2020 0:00,76715,134007,78793,55214,144875,566281,845163,870092679.3,746,75072,2004,84710,15580,5305
9/10/2020 0:00,77739,131284,77918,53366,144515,565545,841344,866988926,769,74783,2045,84514,15540,5272
9/9/2020 0:00,80079,130243,79024,51219,144424,563385,838052,864400778.8,768,74003,2015,84360,15511,5271
9/8/2020 0:00,79704,131317,77885,53432,143900,561079,836296,862074089.8,761,73386,2011,84036,15491,5266
9/7/2020 0:00,75709,131371,76975,54396,143571,559390,834332,859794916.2,754,73539,1904,83660,15459,5244
9/6/2020 0:00,74764,132539,74977,57562,142887,558833,834259,857712781.7,752,73999,1883,83599,15457,5244
9/5/2020 0:00,73515,133399,75826,57573,142875,557984,834258,855087274.8,746,74295,1869,83576,15456,5235
9/4/2020 0:00,73373,133443,75824,57619,142821,557984,834248,851751396.3,746,74689,1875,82871,15441,5235
9/3/2020 0:00,70380,133048,76226,56822,142625,556879,832552,848164195,751,74282,1870,82789,15386,5266
9/2/2020 0:00,69605,132261,76216,56045,142529,556099,830889,845328316.2,746,73359,1866,82645,15359,5261
9/1/2020 0:00,80471,134435,76729,57706,142354,553393,830182,842846676.7,732,72327,2065,82646,15336,5239
8/31/2020 0:00,80810,134266,77054,57212,142206,551575,828047,840478856,750,71856,2024,82307,15310,5224
8/30/2020 0:00,78545,134444,74074,60370,142085,550844,827373,838284630.5,765,71793,1963,82206,15293,5210
8/29/2020 0:00,79676,133955,74578,59377,141958,550196,826109,835994073.3,759,72276,1968,82181,15290,5207
8/28/2020 0:00,77839,134155,74756,59399,141882,550058,826095,832636909.6,758,72660,1929,82128,15280,5194
8/27/2020 0:00,76803,135143,74028,61115,141769,549003,825915,829393226.4,758,72144,1919,81637,15208,5186
8/26/2020 0:00,76198,133084,73555,59529,141696,548474,823254,826750698.9,772,71366,1892,81581,15181,5149
8/25/2020 0:00,78024,127810,73728,54082,140988,547634,816432,824456679.9,784,70718,1912,81471,15155,5147
8/24/2020 0:00,77003,128649,73210,55439,140739,545874,815262,822209302.1,772,70053,1890,81444,15126,5131
8/23/2020 0:00,74403,129881,74040,55841,140505,543429,813815,819966508.6,755,70386,1670,81310,15076,5111
8/22/2020 0:00,74300,130700,74524,56176,140079,542945,813724,817643349.8,753,70693,1619,81284,15057,5111
8/21/2020 0:00,74217,130808,74439,56369,140016,542814,813638,814456895.8,752,71094,1601,81118,15056,5111
8/20/2020 0:00,75909,128651,74068,54583,139929,542113,810693,811333663.2,751,70698,1634,80726,14988,5105
8/19/2020 0:00,79335,128466,73585,54881,139665,539412,807543,808776824.8,747,70125,1673,80572,14969,5095
8/18/2020 0:00,76357,128560,75200,53360,139434,537690,805684,806188548.8,736,69727,1625,80395,14942,5090
8/17/2020 0:00,75614,130431,69914,60517,139189,535997,805617,803949734.5,735,68449,1605,80058,14859,5093
8/16/2020 0:00,72313,131375,68901,62474,138989,534778,805142,801652754.6,728,67796,1598,79953,14839,5108
8/15/2020 0:00,75846,128770,69782,58988,138973,533897,801640,799274526,719,68328,1662,79884,14830,5106
8/14/2020 0:00,76311,127383,69906,57477,138964,533773,800120,796048136.7,721,68654,1656,79815,14822,5106
8/13/2020 0:00,75354,126235,69095,57140,138743,532677,797655,793068767.6,717,77921,1556,79631,14761,5101
8/12/2020 0:00,75151,125605,66221,59384,138470,531739,795814,790537704.8,741,77571,1540,79467,14712,5097
8/11/2020 0:00,73622,125844,65790,60054,138235,530596,794675,788196489,750,76849,1512,78803,14697,5101
8/10/2020 0:00,72848,125997,66234,59763,138024,529581,793602,786031667.5,744,78602,1500,78604,14619,5107
8/9/2020 0:00,74264,124301,65507,58794,137588,528105,789994,783755633.7,753,78254,1547,78568,14597,5086
8/8/2020 0:00,74598,124631,66162,58469,137555,527450,789636,781576541.1,750,78591,1564,78552,14594,5091
8/7/2020 0:00,74441,124703,65039,59664,137544,527315,789562,778507418,746,78889,1561,78515,14590,5091
8/6/2020 0:00,73693,123868,62317,61551,137300,526908,788076,775370849.6,768,78270,1576,78418,14557,5074
8/5/2020 0:00,70899,128467,65446,63021,136835,522293,787595,772887274.3,738,77294,1539,78260,14494,5070
8/4/2020 0:00,70396,128652,67451,61201,136738,519994,785384,770541163.3,723,76881,1516,78154,14473,5057
8/3/2020 0:00,74539,130638,68690,61948,136067,518141,784846,767989247.3,750,76283,1613,78047,14458,5033
8/2/2020 0:00,74020,130195,67276,62919,135841,516845,782881,765494781.1,739,76364,1623,75536,14355,5028
8/1/2020 0:00,74678,130071,67727,62344,135771,516328,782170,763245700.8,736,76673,1624,75506,14349,5012
7/31/2020 0:00,74139,130479,67908,62571,135623,516068,782170,760168272.6,736,76962,1610,75478,14336,5013
7/30/2020 0:00,71163,130558,68099,62459,135504,515630,781692,757195527.1,736,76265,1578,75380,14272,4998
7/29/2020 0:00,73123,128502,67569,60933,135402,515040,778944,754755750.6,763,75838,1605,75056,14193,4940
7/28/2020 0:00,74813,128197,67619,60578,135187,513212,776596,752491619.1,764,75574,1680,74942,14127,4915
7/27/2020 0:00,75450,127797,65849,61948,135081,512304,775182,750133436.6,758,74740,1705,74833,14101,4906
7/26/2020 0:00,74430,129048,63844,65204,134846,510309,774203,747820054.4,794,74302,1735,74720,14049,4893
7/25/2020 0:00,74945,129061,63815,65246,134761,509583,773405,745694724,791,74578,1733,74698,14044,4890
7/24/2020 0:00,74844,129032,63589,65443,134517,509409,772958,742845093.5,791,74666,1732,74649,14014,4873
7/23/2020 0:00,75832,127592,62544,65048,134321,508790,770703,739978397.1,788,74287,1738,73999,13967,4867
7/22/2020 0:00,73702,127088,61572,65516,133782,508034,768904,737473488.6,797,73750,1689,73743,13909,4827
7/21/2020 0:00,75451,126163,62951,63212,133068,505671,764902,734891309.5,818,72770,1764,73731,13876,4797
7/20/2020 0:00,78515,124831,62427,62404,132481,504517,761829,732775221.1,836,72396,1948,73616,13863,4771
7/19/2020 0:00,78276,125012,61740,63272,132311,503150,760473,731224256.6,847,72039,1986,73480,13851,4740
7/18/2020 0:00,78339,125637,61638,63999,132181,502655,760473,729123840.7,844,72263,1975,73451,13843,4740
7/17/2020 0:00,78389,125738,61834,63904,132135,502507,760380,726335311.6,845,72189,1977,73330,13836,4710
7/16/2020 0:00,78356,124750,63325,61425,131970,500718,757438,723453054.1,854,72133,1968,73130,13765,4656
7/15/2020 0:00,75238,124243,64052,60191,131723,496218,752184,721147347.4,871,71569,2061,72808,13712,4654
7/14/2020 0:00,77548,129399,71211,58188,131577,488576,749552,718955684.8,884,70767,2089,73286,13689,4645
7/13/2020 0:00,76982,133640,75633,58007,130345,484190,748175,716820717.2,908,70696,2088,73108,13664,4609
7/12/2020 0:00,77210,135325,75711,59614,129873,480930,746128,714800471.3,905,70782,2084,72833,13652,4610
7/11/2020 0:00,76630,135646,75469,60177,129855,480542,746043,712893953.4,902,71219,2081,72780,13650,4611
7/10/2020 0:00,76015,136556,76285,60271,129694,479726,745976,710034566,889,71418,2041,72752,13641,4610
7/9/2020 0:00,75936,135342,75050,60292,129432,479592,744366,707431499.3,889,71118,1914,72620,13609,4598
7/8/2020 0:00,78135,135085,75267,59818,129108,478015,742208,705200581.5,901,70555,1942,72402,13536,4579
7/7/2020 0:00,80506,136869,76657,60212,128919,474611,740399,703071735.9,891,69725,2037,72265,13512,4576
7/6/2020 0:00,81140,138144,78519,59625,128581,471884,738609,700833913.8,873,69434,2078,72159,13498,4562
7/5/2020 0:00,81909,138593,77987,60606,128460,470277,737330,698883058,775,69275,2216,72068,13492,4568
7/4/2020 0:00,81769,139288,78644,60644,128401,469621,737310,696999768.1,772,69411,2215,72057,13492,4569
7/3/2020 0:00,81899,139280,78644,60636,128378,469621,737279,695487458.1,772,69823,2218,72018,13489,4569
7/2/2020 0:00,85239,138249,78689,59560,128272,469621,736142,692385141.7,772,69802,2373,71937,13468,4568
7/1/2020 0:00,88142,131711,77101,54610,127941,469297,728949,689629755.2,773,69188,2403,71811,13443,4561
6/30/2020 0:00,91183,131708,77572,54136,126761,467380,725849,687200765.7,766,67883,2602,71664,13415,4554
6/29/2020 0:00,92451,131871,78973,52898,126446,466121,724438,685157667.1,793,67087,2636,71527,13363,4542
6/28/2020 0:00,90982,132643,77457,55186,126115,465357,724115,683236291.2,797,66884,2621,71249,13298,4531
6/27/2020 0:00,91147,133578,78344,55234,126043,464472,724093,681392429.8,793,67170,2624,71223,13295,4529
6/26/2020 0:00,91578,133236,77718,55518,125986,464350,723572,678810198.1,796,67483,2635,71189,13292,4526
6/25/2020 0:00,87593,132599,77853,54746,125605,464056,722260,676264629.1,841,66956,2566,71079,13257,4512
6/24/2020 0:00,85995,131829,77266,54563,125290,462922,720041,674274597.7,868,66449,2409,70917,13234,4481
6/23/2020 0:00,85480,131226,77111,54115,125223,461616,718065,672349902.7,889,65697,2248,70749,13181,4493
6/22/2020 0:00,86263,129165,76639,52526,124971,459869,714005,670558529.9,903,64810,2243,70627,13166,4495
6/21/2020 0:00,87599,127321,75724,51597,124575,458379,710275,668854198.6,910,64726,2268,70578,13158,4501
6/20/2020 0:00,87642,128588,76759,51829,124552,457135,710275,667314582.5,902,64798,2265,70557,13153,4503
6/19/2020 0:00,83170,128890,75692,53198,124392,456992,710274,665125852.5,901,64901,2255,70535,13135,4498
6/18/2020 0:00,82061,129032,74844,54188,124078,456199,709309,662803578,901,64464,2210,70507,13248,4484
6/17/2020 0:00,82277,130196,73440,56756,123516,452956,706668,660929915.6,894,64663,2092,70401,13232,4477
6/16/2020 0:00,81991,130689,72916,57773,123095,449780,703564,659202397.1,910,64253,1904,70299,13206,4474
6/15/2020 0:00,89172,124406,64900,59506,122701,449186,696293,657385100.5,912,63341,1731,70222,13181,4454
6/14/2020 0:00,90829,121629,63342,58287,122529,448239,692397,655813334.4,908,63258,1650,70153,13170,4431
6/13/2020 0:00,91201,122691,64177,58514,122509,447192,692392,654179635.5,902,63398,1654,70124,13166,4420
6/12/2020 0:00,92072,123067,64802,58265,122417,446207,691691,652049207.3,891,63395,1685,70091,13155,4403
6/11/2020 0:00,89417,124704,66304,58400,122348,444221,691273,649866288.6,881,63298,1657,70037,13094,4405
6/10/2020 0:00,92468,116950,65941,51009,122261,442735,681946,648142718.5,884,63386,1622,69941,13079,4402
6/9/2020 0:00,91861,118047,64424,53623,121817,441277,681141,646531808.2,891,62746,1635,69857,13051,4402
6/8/2020 0:00,92694,118120,65277,52843,121385,439609,679114,644989775.9,885,62289,1716,69674,13039,4407
6/7/2020 0:00,92228,117955,63041,54914,121151,438238,677344,643579934.1,757,62185,1685,69594,13024,4399
6/6/2020 0:00,93062,118395,63369,55026,121101,437017,676513,642167047,749,62224,1679,69561,13019,4398
6/5/2020 0:00,93059,118878,62170,56708,120990,436626,676494,640308102.2,737,62480,1681,69527,13009,4400
6/4/2020 0:00,94385,116648,63078,53570,120614,435599,672861,638414527.6,760,62121,1715,69454,12988,4387
6/3/2020 0:00,94180,115176,61452,53724,120079,433922,669177,636940833,768,61357,1782,69308,12954,4371
6/2/2020 0:00,93318,116072,63068,53004,119542,431326,666940,635434215.2,762,60572,1787,69189,12921,4362
6/1/2020 0:00,94705,115926,64288,51638,119271,429893,665090,633937120.1,772,59707,1772,68933,12778,4357
5/31/2020 0:00,92957,116677,65289,51388,118726,427605,663008,632543209.6,782,59536,1759,68743,12718,4345
5/30/2020 0:00,93341,117913,65862,52051,118587,426329,662829,631138394.2,775,59693,1760,68710,12717,4348
5/29/2020 0:00,93306,119218,67127,52091,118547,425064,662829,629096665.8,772,59474,1748,68642,12711,4345
5/28/2020 0:00,92471,119719,65896,53823,118404,424656,662779,627159346,793,59036,1728,68546,12692,4345
5/27/2020 0:00,89978,118522,64831,53691,118230,424051,660803,625323498.5,818,57878,1799,68269,12680,4338
5/26/2020 0:00,89541,118360,66476,51884,117941,421914,658215,623351084.1,823,57208,1921,68162,12668,4329
5/25/2020 0:00,90348,117034,65670,51364,117365,420593,654992,621162707.6,826,56610,1908,67277,12569,4319
5/24/2020 0:00,90062,117490,66131,51359,117336,419638,654464,618991862,820,56482,1908,67219,12563,4309
5/23/2020 0:00,87970,118591,66771,51820,117234,418639,654464,618991862,812,56269,1885,67174,12561,4308
5/22/2020 0:00,87906,119561,66906,52655,116337,418484,654382,618991862,809,56100,1916,67061,12544,4303
5/21/2020 0:00,89387,117191,66201,50990,116174,417937,651302,618991862,806,54659,1998,66939,12519,4279
5/20/2020 0:00,90252,115479,66704,48775,115894,415911,647284,618991862,786,53604,2019,66841,12495,4282
5/19/2020 0:00,91779,116034,68102,47932,115631,414081,645746,618991862,786,52698,2355,66800,12460,4270
5/18/2020 0:00,90088,117265,69322,47943,115128,412359,644752,618991862,779,52104,2403,66759,12459,4242
5/17/2020 0:00,89520,117067,68241,48826,115094,411490,643651,618991862,770,51678,2518,66742,12457,4240
5/16/2020 0:00,89787,118258,68942,49316,115072,410321,643651,618991862,761,51659,2518,66742,12457,4240
5/15/2020 0:00,89645,118570,69102,49468,114920,410161,643651,618991862,758,51656,2469,66739,12457,4240
5/14/2020 0:00,87914,117392,66044,51348,114818,410006,642216,618991862,758,51627,2461,66457,12453,4242
5/13/2020 0:00,88447,115169,66670,48499,114537,408486,638192,618991557,742,51457,2523,66327,12420,4238
5/12/2020 0:00,88695,116007,66006,50001,114014,406590,636611,618991557,730,50961,2589,68927,12413,4227
5/11/2020 0:00,85418,118566,66113,52453,113121,404912,636599,618991557,729,50570,2569,68914,12409,4231
5/10/2020 0:00,83798,119187,65312,53875,112969,403090,635246,618991557,615,50178,2378,68864,12407,4238
5/9/2020 0:00,83527,120422,65962,54460,112926,401587,634935,618991557,605,50180,2394,68861,12405,4238
5/8/2020 0:00,82875,120712,65713,54999,112790,401368,634870,618991557,601,50237,2396,68860,12405,4238
5/7/2020 0:00,85713,117922,65595,52327,112610,401103,631635,618991557,603,49966,2489,68637,12401,4238
5/6/2020 0:00,86699,116520,66625,49895,112524,400083,629127,618991557,617,49677,2425,68400,12400,4239
5/5/2020 0:00,88891,114288,66555,47733,112364,398795,625447,618991557,629,49618,2392,68387,12401,4249
5/4/2020 0:00,88082,114882,66928,47954,111875,396908,623665,618991557,639,49203,2409,68347,12391,4248
5/3/2020 0:00,86508,117790,67775,50015,111071,394729,623590,618991557,644,48923,2436,68313,12387,4257
5/2/2020 0:00,86548,118437,67940,50497,111055,394098,623590,618991557,642,48868,2431,68283,12387,4257
5/1/2020 0:00,86319,118777,67791,50986,110949,393864,623590,618991557,639,48841,2427,67661,12388,4257
4/30/2020 0:00,85346,118632,67752,50880,110809,393150,622591,618991557,655,48909,2459,67365,12366,4257
4/29/2020 0:00,70084,117543,69729,47814,110615,390292,618450,618991557,660,48618,2424,67341,12364,4258
4/28/2020 0:00,70660,117380,68586,48794,110421,389043,616844,618991557,662,48240,2426,67333,12363,4265
4/27/2020 0:00,72465,117992,71648,46344,110268,385964,614224,618991557,667,47934,2471,67280,12358,4269
4/26/2020 0:00,71170,117576,69648,47928,109962,385494,613032,618991557,668,47881,2468,67224,12354,4275
4/25/2020 0:00,70208,117690,69290,48400,109940,385402,613032,618991557,670,47777,2459,67223,12354,4275
4/24/2020 0:00,70518,117709,68884,48825,109625,385306,612640,618991557,669,47737,2439,67217,12354,4275
4/23/2020 0:00,68903,117236,68375,48861,109356,384756,611348,618991557,692,47525,1739,67203,12341,4270
4/22/2020 0:00,72494,118438,67894,50544,108595,381795,608828,618991557,693,47366,1874,64605,12341,4246
4/21/2020 0:00,71008,117527,68550,48977,108448,380364,606339,618991557,693,47174,1657,64612,12341,4242
4/20/2020 0:00,74165,115886,66046,49840,108142,379775,603803,618991557,691,47109,1696,64438,12332,4253
4/19/2020 0:00,66058,117409,67133,50276,107671,378123,603203,618991557,669,47029,1594,65337,12332,4251
4/18/2020 0:00,66404,118279,67436,50843,107608,377079,602966,618991557,660,47022,1594,64956,12322,4251
4/17/2020 0:00,66885,118357,67206,51151,107544,376983,602884,618991557,659,47154,1607,64953,12322,4354
4/16/2020 0:00,67631,118176,67304,50872,107188,376165,601529,618991557,650,46981,1594,64905,12316,4340
4/15/2020 0:00,67620,118234,67030,51204,106529,374194,598957,618991557,670,46845,1570,64763,12305,4327
4/14/2020 0:00,67415,118288,67532,50756,105977,371683,595948,618991557,669,46878,1586,64653,12301,4325
4/13/2020 0:00,69983,118643,69252,49391,105772,369167,593582,618991557,668,46678,1562,64576,12301,4315
4/12/2020 0:00,64023,119630,69305,50325,105463,366595,591688,618991557,498,48218,1542,64517,12297,4311
4/11/2020 0:00,64295,119680,69039,50641,105406,366342,591428,618991557,496,48224,1544,64586,12297,4310
4/10/2020 0:00,64403,119316,69039,50277,105365,366342,591023,618991557,497,48525,1553,64576,12295,4319
4/9/2020 0:00,65082,119814,69694,50120,104641,365595,590050,618991557,528,48263,1619,64517,12294,4318
4/8/2020 0:00,67455,117097,67901,49196,103862,364758,585717,618991557,564,48053,1655,64605,12293,4393
4/7/2020 0:00,66874,118006,66008,51998,103376,363819,585201,618991557,572,48208,1662,64565,12290,4369
4/6/2020 0:00,68570,117874,65760,52114,102994,362530,583398,618991557,580,47842,1723,64658,12205,4377
4/5/2020 0:00,68405,118100,67550,50550,102969,360445,581514,618991617,617,47570,1743,64633,12205,4377
4/4/2020 0:00,68760,119086,68011,51075,102873,359529,581488,618991617,618,49713,1750,64626,12205,4377
4/3/2020 0:00,68919,119307,67546,51761,102752,359382,581441,618991617,618,50557,1754,64623,12205,4377
4/2/2020 0:00,70053,118680,68179,50501,102511,357716,578907,618991675,672,53544,1821,64597,12203,4369
4/1/2020 0:00,72734,115410,69232,46178,102236,355849,573495,618991675,683,53869,1781,64435,12212,4367
3/31/2020 0:00,71865,116097,69273,46824,101863,354164,572124,618991675,691,53501,1808,64528,12210,4374
3/30/2020 0:00,72924,116568,67539,49029,101155,353064,570787,618991675,686,55471,1835,64462,12209,4387
3/29/2020 0:00,72172,119297,69366,49931,100629,350595,570521,618988413,677,55640,1843,64409,12204,4386
3/28/2020 0:00,71351,119168,68719,50449,100590,350471,570229,618988413,676,57097,1837,64405,12204,4388
3/27/2020 0:00,71197,119362,68680,50682,100583,350150,570095,618988413,671,58537,1834,64404,12203,4388
3/26/2020 0:00,73042,118539,66906,51633,100211,349373,568123,618988458,660,61229,1890,64340,12199,4396
3/25/2020 0:00,73123,118984,67500,51484,99207,347518,565709,618988498,660,61268,1908,64259,12197,4425
3/24/2020 0:00,75956,117616,67470,50146,99174,345893,562683,618988105,647,61429,1927,64179,12181,4426
3/23/2020 0:00,66626,114619,65707,48912,98082,344676,557377,618002996.7,646,62056,1846,64031,12128,4428
3/22/2020 0:00,66552,115326,65857,49469,97684,343492,556502,615502863.9,640,62212,1851,63963,12100,4427
3/21/2020 0:00,65365,115707,65970,49737,97602,342936,556245,613786472.1,635,62642,1822,63943,12099,4427
3/20/2020 0:00,64813,115876,65932,49944,97553,342740,556169,611359098.9,635,62677,1782,63902,12091,4423
3/19/2020 0:00,68286,113770,65471,48299,97360,341446,552576,608624382.7,667,62129,1962,63759,12082,4424
3/18/2020 0:00,70450,111970,65862,46108,96887,339331,548188,606791155.7,654,61469,1964,63520,12064,4420
3/17/2020 0:00,71707,111382,66241,45141,96526,336849,544757,604957489.9,640,61229,1993,63327,12032,4412
3/16/2020 0:00,69426,114128,67492,46636,96136,334355,544619,602968754,631,60822,1883,63260,11989,4404
3/15/2020 0:00,68235,115213,67867,47346,95908,332914,544035,600492981.5,519,60379,1894,63080,11913,4402
3/14/2020 0:00,68313,116423,68646,47777,95726,331886,544035,598259557.6,523,60725,1896,63053,11911,4402
3/13/2020 0:00,68135,118157,69732,48425,95532,330346,544035,595252038,515,60873,1868,62993,11908,4399
3/12/2020 0:00,66785,116920,69045,47875,95292,330184,542396,591934406.2,526,60378,1904,62878,11812,4395
3/11/2020 0:00,69332,113714,69863,43851,95012,329171,537897,589602678.6,537,59874,1859,62687,11768,4387
3/10/2020 0:00,69609,114734,69157,45577,94815,326596,536145,587754447.5,529,59761,1845,62551,11734,4393
3/9/2020 0:00,67114,115922,70282,45640,94447,325097,535466,586062905.5,526,58886,1831,62355,11692,4391
3/8/2020 0:00,66478,117620,69934,47686,94202,323257,535079,584543824.7,531,58871,1818,62191,11651,4358
3/7/2020 0:00,63712,118119,69668,48451,94047,322657,534823,582667325.4,534,59060,1828,62175,11650,4355
3/6/2020 0:00,65287,116509,69748,46761,93977,322115,532601,579974739.3,541,59319,1828,62138,11649,4355
3/5/2020 0:00,64806,116358,67871,48487,93662,321791,531811,577522694.3,557,60359,1799,62006,11466,4353
3/4/2020 0:00,65800,114439,68801,45638,93592,320503,528534,575640827.9,581,59470,1547,61875,11371,4347
3/3/2020 0:00,66871,113890,69484,44406,93087,319167,526144,573940431.9,591,59763,1484,61766,11348,4317
3/2/2020 0:00,64368,111851,67636,44215,92642,317923,522416,572267036.3,592,59016,1320,61627,11338,4285
3/1/2020 0:00,63525,111914,67107,44807,92452,316533,520899,570695090.9,587,58663,1311,61498,11332,4278
2/29/2020 0:00,62463,112067,67978,44089,92434,315662,520163,568722119.3,583,59044,1322,61461,11323,4275
2/28/2020 0:00,61937,112302,68469,43833,92312,314967,519581,566025229.2,580,59299,1308,61412,11323,4275
2/27/2020 0:00,63134,111484,67060,44424,92211,314401,518096,563453741.4,578,58691,1292,61208,11272,4265
2/26/2020 0:00,66527,109952,65691,44261,91701,313516,515169,561656496.9,576,58018,1273,60941,11236,4244
2/25/2020 0:00,63881,111280,66311,44969,91545,312174,514999,559915439.2,566,57511,1254,61711,11217,4254
2/24/2020 0:00,60791,111754,65847,45907,91482,311311,514547,558356457.5,567,57127,1251,60178,11088,4239
2/23/2020 0:00,62865,112225,69041,43184,90518,308386,511129,556853344.4,555,56332,1365,59832,11068,4218
2/22/2020 0:00,62893,112243,68502,43741,90490,308386,511119,555085961.4,557,56566,1365,59788,11066,4218
2/21/2020 0:00,62619,112086,68319,43767,90470,308261,510817,552588576,559,56549,1356,59720,11062,4213
2/20/2020 0:00,62447,110502,66822,43680,90286,308070,508858,550112186.6,560,55806,1495,58902,11005,4216
2/19/2020 0:00,65999,108323,67405,40918,89512,307060,504895,548258722.5,555,55624,1557,58676,10967,4186
2/18/2020 0:00,72869,103740,67553,36187,88850,304904,497494,546581623.8,548,55069,1691,58488,10957,4136
2/17/2020 0:00,74248,102849,66805,36044,88621,303712,495182,545090125.9,545,54520,1727,58326,10927,4106
2/16/2020 0:00,75105,102583,66968,35615,88155,302047,492785,543108642.3,427,54446,1705,58155,10903,4100
2/15/2020 0:00,75434,103142,66698,36444,87962,301411,492515,541156640.7,428,54667,1708,58136,10898,4097
2/14/2020 0:00,74125,103304,67203,36101,87948,300906,492158,538220929.6,428,54756,1690,58098,10895,4099
2/13/2020 0:00,73093,103841,66794,37047,87725,300390,491956,535380921.7,424,54173,1608,57981,10875,4081
2/12/2020 0:00,67387,102263,64677,37586,87294,300059,489616,533854536.9,426,54348,1569,57885,10873,4070
2/11/2020 0:00,65127,103845,64747,39098,86852,298819,489516,532504496.2,445,54199,1529,57790,10852,4062
2/10/2020 0:00,65153,105347,66701,38646,86528,296123,487998,531176709.7,452,53330,1535,57693,10786,4056
2/9/2020 0:00,65281,106980,67244,39736,86373,294474,487827,529799218.3,482,53057,1561,57650,10760,4054
2/8/2020 0:00,65036,107271,66858,40413,86150,294285,487706,528044708.3,491,53116,1545,57628,10759,4054
2/7/2020 0:00,66281,106216,66754,39462,86086,294142,486444,525525296.1,489,53268,1554,57585,10759,4057
2/6/2020 0:00,68141,103192,66254,36938,85889,293523,482604,523360434.8,506,52774,1570,57446,10733,4044
2/5/2020 0:00,68360,103035,66510,36525,85830,293007,481872,521962798.5,525,52356,1541,57293,10710,4006
2/4/2020 0:00,65599,104024,67436,36588,84960,290825,479809,520417529.9,516,51743,1223,57205,10690,3993
2/3/2020 0:00,63284,103810,63670,40140,84452,289730,477992,518993050.3,530,50957,1239,57273,10659,3983
2/2/2020 0:00,63454,103713,62568,41145,84385,289520,477618,517582312.4,535,50563,1220,57027,10610,3970
2/1/2020 0:00,63920,103517,62812,40705,84359,289280,477156,515999747.5,534,50649,1226,56992,10610,3987
1/31/2020 0:00,61785,103858,62336,41522,84168,289130,477156,513403509,543,50720,1205,56955,10608,3987
1/30/2020 0:00,60516,103245,59944,43301,83929,288988,476162,511137539.6,544,50162,1199,57030,10575,3968
1/29/2020 0:00,58221,101016,58955,42061,83622,288132,472770,509446808.4,540,49835,1127,56884,10554,3936
1/28/2020 0:00,59581,100234,60188,40046,83463,286057,469754,507964253.8,538,49165,1182,56551,10523,3927
1/27/2020 0:00,60126,97766,58827,38939,83089,285335,466190,506614889,545,48494,1346,56385,10492,3836
1/26/2020 0:00,60262,99514,60394,39120,82779,283526,465819,505355851.1,539,47913,1346,56266,10418,3822
1/25/2020 0:00,57056,99837,58693,41144,82774,283104,465715,503698537.1,532,48207,1329,56257,10416,3806
1/24/2020 0:00,57722,99034,58399,40635,82761,283103,464898,501322912.5,534,48246,1333,56223,10415,3805
1/23/2020 0:00,57049,97951,57413,40538,82716,282980,463647,499138682.7,550,47225,1476,56042,10395,3807
1/22/2020 0:00,59903,94647,56070,38577,82639,282092,459378,497520564.9,549,46706,1439,56392,10361,3784
1/21/2020 0:00,56984,96582,57281,39301,82026,279548,458156,496129317.1,533,46425,1382,57943,10297,3776
1/20/2020 0:00,56648,97143,57361,39782,81537,278674,457354,494807614.6,540,45924,1394,59001,10293,3768
1/19/2020 0:00,55883,97460,56564,40896,81028,278116,456604,493105988.7,426,45762,1400,58905,10264,3768
1/18/2020 0:00,54818,97851,56444,41407,80932,277732,456515,491619019.2,425,45947,1397,58899,10264,3768
1/17/2020 0:00,53690,98449,56963,41486,80853,277213,456515,489538928.6,434,45936,1377,58868,10262,3768
1/16/2020 0:00,54053,99249,56590,42659,80364,275968,455581,487182400.6,398,45643,1379,58508,10226,3767
1/15/2020 0:00,53371,98514,56302,42212,80089,275132,453735,485608801.6,395,44851,1358,58445,10206,3757
1/14/2020 0:00,56217,97569,52850,44719,79501,272506,449576,484148704.1,396,44274,1380,58729,10197,3745
1/13/2020 0:00,55564,96143,52691,43452,79117,272034,447294,482778100.3,413,43938,1418,58654,10186,3730
1/12/2020 0:00,53755,99094,54847,44247,78359,269841,447294,481527522.8,445,43462,1390,58584,10175,3715
1/11/2020 0:00,53846,99185,54925,44260,78338,269491,447014,479955618.9,444,43594,1387,58554,10175,3716
1/10/2020 0:00,54846,98365,55050,43315,78329,269367,446061,477661472.4,446,43778,1411,58533,10170,3716
1/9/2020 0:00,51725,98253,54842,43411,77760,268803,444816,475557379.9,470,43229,1350,58513,10133,3720
1/8/2020 0:00,44439,100341,54457,45884,77417,266414,444172,473972996,481,43002,1204,59009,10091,3717
1/7/2020 0:00,48051,97645,55493,42152,76132,265070,438847,472566744.8,497,42401,872,58933,10066,3717
1/6/2020 0:00,48983,98233,55827,42406,75277,263690,437200,471196492.2,492,42015,922,58730,10045,3728
1/5/2020 0:00,46505,99190,55390,43800,74600,262926,436716,469953031,503,41884,874,58655,10021,3718
1/4/2020 0:00,45025,99554,55182,44372,74490,262667,436711,468504226.3,505,42133,879,58641,10021,3718
1/3/2020 0:00,44307,98886,55541,43345,74489,262308,435683,466413770.8,501,42093,844,58619,10020,3724
1/2/2020 0:00,44508,95991,54179,41812,74411,262095,432497,464275022.4,504,41559,798,58431,9995,3722
1/1/2020 0:00,44466,94580,54630,39950,74159,260556,429295,462419396.5,507,41405,763,59059,9807,3694
12/31/2019 0:00,44216,94604,54630,39974,74135,260556,429295,461564252.2,528,41427,757,59036,9805,3694
12/30/2019 0:00,43316,96038,53567,42471,73235,259542,428815,459676536.5,527,41052,857,58806,9795,3688
12/29/2019 0:00,47702,94877,52868,42009,72857,259024,426758,458135639,533,40887,1059,58690,9766,3688
12/28/2019 0:00,43336,95347,52732,42615,72836,258575,426758,456430828,535,41152,1029,58669,9764,3689
12/27/2019 0:00,44466,94679,53020,41659,72698,258287,425664,454101111.3,534,41115,1059,58638,9759,3687
12/26/2019 0:00,44001,94429,53136,41293,72555,256772,423756,451543538.6,525,40943,1023,58672,9726,3689
12/25/2019 0:00,48233,90009,51980,38029,72282,255292,417583,449432959.3,516,41048,1070,58522,9715,3690
12/24/2019 0:00,48233,90522,50564,39958,71769,255292,417583,449427349.5,516,41117,1070,58522,9715,3690
12/23/2019 0:00,50084,90183,51051,39132,71534,254809,416526,447769932.5,529,40865,1105,58351,9709,3691
12/22/2019 0:00,47466,90937,49338,41599,71060,253803,415800,445471834.1,524,40271,1124,58260,9634,3699
12/21/2019 0:00,48265,92079,50018,42061,70768,252145,414992,443651692.5,400,40555,1129,58286,9631,3699
12/20/2019 0:00,48525,91887,49750,42137,70743,252145,414775,441374649.2,400,40546,1134,58257,9625,3699
12/19/2019 0:00,52321,87524,48862,38662,70635,252063,410222,439057427.8,401,39802,1163,57903,9574,3696
12/18/2019 0:00,54463,84012,47691,36321,70169,250765,404946,437268575.8,419,39332,1148,58052,9764,3691
12/17/2019 0:00,53423,83992,47709,36283,69957,250008,403957,435715256.8,423,38802,1136,57596,9697,3688
12/16/2019 0:00,48929,84206,46562,37644,69643,249011,402860,434777657.5,465,39086,1086,57409,9653,3691
12/15/2019 0:00,49685,83101,45666,37435,69047,248768,400916,433321949.2,484,39180,1120,57327,9650,3688
12/14/2019 0:00,49226,83662,45722,37940,69038,248171,400871,431893146.7,501,39379,1106,57291,9649,3686
12/13/2019 0:00,48966,83682,44381,39301,69018,248171,400871,429849952.5,503,39543,1099,57268,9649,3687
12/12/2019 0:00,54065,81640,44975,36665,68882,246526,397048,427804382.5,523,38883,1119,57096,9621,3647
12/11/2019 0:00,57936,78680,45439,33241,68548,245770,392998,426269055.5,538,38530,1099,56915,9586,3635
12/10/2019 0:00,56789,81590,49506,32084,68149,241714,391453,425054390.9,522,37930,850,56815,9583,3628
12/9/2019 0:00,57970,79570,50782,28788,67940,240360,387870,423778552,544,37263,904,56085,8998,3627
12/8/2019 0:00,57526,79601,50428,29173,67852,239959,387412,422617277.7,567,36983,906,54931,8853,3608
12/7/2019 0:00,54855,79798,49788,30010,67826,239672,387296,421182224.8,586,37229,909,54918,8852,3608
12/6/2019 0:00,54641,81054,50302,30752,67671,238571,387296,419287421.3,588,37200,912,54892,8850,3608
12/5/2019 0:00,55918,82093,50357,31736,67427,236222,385742,417498832.6,594,36676,1012,54797,8838,3610
12/4/2019 0:00,54519,81399,50673,30726,67350,234380,383129,416080335.8,592,36115,958,52540,8832,3608
12/3/2019 0:00,53548,83645,52222,31423,66966,232347,382958,414734550.5,579,35931,1049,49831,8630,3579
12/2/2019 0:00,52847,83797,46925,36872,66808,231616,382221,413737885.2,560,35744,1060,49791,8627,3572
12/1/2019 0:00,52277,83715,47307,36408,66580,231242,381537,412956266.5,532,35632,1147,49739,8619,3570
11/30/2019 0:00,47725,83145,47055,36090,66519,231084,380748,411815898.6,533,36257,1178,49734,8619,3570
11/29/2019 0:00,47822,83502,46882,36620,66449,230700,380651,409683779.7,533,36304,1185,49705,8615,3569
11/28/2019 0:00,52278,79480,46313,33167,66378,230416,376274,407039199.8,546,36299,1450,49654,8606,3569
11/27/2019 0:00,52128,79436,46313,33123,66316,230416,376168,407015683.8,546,36317,1447,49654,8606,3569
11/26/2019 0:00,53225,80544,47998,32546,66098,228104,374746,404858549.9,542,35975,1527,49586,8574,3566
11/25/2019 0:00,48468,80925,47192,33733,65738,227369,374032,403117648.4,529,35706,1497,49494,8556,3562
11/24/2019 0:00,44731,80792,45888,34904,65439,226571,372802,401669343.3,533,35508,1616,49418,8545,3549
11/23/2019 0:00,44614,82084,47257,34827,65437,225202,372723,400349440.5,406,35918,1612,49405,8540,3549
11/22/2019 0:00,44419,82949,48123,34826,65389,224336,372674,398267677.1,401,35967,1605,49372,8536,3549
11/21/2019 0:00,42386,86101,49871,36230,65295,220751,372147,396340379.7,435,35287,1605,49394,8526,3541
11/20/2019 0:00,41850,87865,50921,36944,65080,218724,371669,394895682.3,439,34600,1585,49241,8468,3501
11/19/2019 0:00,44632,85876,50045,35831,64895,218196,368967,393639975,468,34147,1615,49161,8451,3491
11/18/2019 0:00,47208,83643,51726,31917,64830,216542,365015,392523555.4,471,33453,2008,49029,8441,3479
11/17/2019 0:00,47890,82724,50418,32306,64664,216182,363570,391404833.5,502,33035,2089,48946,8434,3476
11/16/2019 0:00,44320,83005,50141,32864,64554,216001,363560,390040947,498,33130,2042,48918,8430,3476
11/15/2019 0:00,44231,82953,49898,33055,64551,216001,363505,388015172,503,33151,2037,48880,8423,3476
11/14/2019 0:00,45570,83750,51001,32749,64363,214683,362796,386140340.9,532,32508,2041,48795,8401,3471
11/13/2019 0:00,48543,82948,53119,29829,64244,212558,359750,384748241.7,668,32442,2061,48754,8393,3431
11/12/2019 0:00,39484,81805,54099,27706,64076,210745,356626,383550084,691,35546,1706,48568,8341,3431
11/11/2019 0:00,38451,81857,54109,27748,63910,209969,355736,382501790.8,682,35656,1702,48474,8307,3435
11/10/2019 0:00,36796,83397,54747,28650,62518,209323,355238,381344062.4,703,35590,1807,48376,8289,3429
11/9/2019 0:00,36871,83437,54500,28937,62403,209323,355163,379891828.2,705,35518,1807,48240,8268,3429
11/8/2019 0:00,36977,83449,54477,28972,62391,209323,355163,377889750.7,705,35716,1803,48227,8267,3426
11/7/2019 0:00,37685,84300,55495,28805,61678,208208,354186,375941443.9,717,35026,1812,47773,8246,3417
11/6/2019 0:00,39187,84541,54966,29575,61350,207180,353071,374600452.7,717,34522,1796,47593,8212,3399
11/5/2019 0:00,39184,85572,55234,30338,60904,206595,353071,373329371.5,705,34061,1797,47367,8209,3375
11/4/2019 0:00,37443,86028,53438,32590,60593,205986,352607,372229493,700,33175,1776,45500,8129,3367
11/3/2019 0:00,37389,85826,54659,31167,60184,204479,350489,371161876,656,32910,1852,43870,7952,3368
11/2/2019 0:00,35515,85260,54411,30849,59908,204479,349647,369777243.7,656,33188,1805,43838,7813,3368
11/1/2019 0:00,35467,85279,54414,30865,59892,204476,349647,367925477.6,649,33207,1797,43817,7812,3368
10/31/2019 0:00,33682,86502,55134,31368,59763,202527,348792,366027741.8,629,32928,1957,43728,7723,3367
10/30/2019 0:00,32544,88570,57038,31532,59099,200359,348028,364772010.4,599,32660,1543,45557,7716,3354
10/29/2019 0:00,31674,89233,57033,32200,58683,198494,346410,363590430.4,579,32115,1275,46055,7693,3342
10/28/2019 0:00,33573,87509,57494,30015,57955,197792,343256,362465232.5,570,31477,1204,45967,7679,3314
10/27/2019 0:00,34152,89068,58518,30550,56379,195919,341366,361355724.1,419,31299,1207,45908,7668,3298
10/26/2019 0:00,31466,89287,58143,31144,56160,195919,341366,360083782,422,31740,1189,45885,7667,3297
10/25/2019 0:00,31468,89355,58196,31159,56142,195869,341366,358235664.8,416,32206,1189,45852,7665,3297
10/24/2019 0:00,30751,91578,60331,31247,56028,193734,341340,356478233.8,395,32063,1181,45754,7642,3284
10/23/2019 0:00,31529,89993,59886,30107,55186,192229,337408,355099867.4,391,31578,984,45673,7624,3265
10/22/2019 0:00,30356,91438,61581,29857,55094,190412,336944,353871879.5,397,30811,980,45591,7622,3253
10/21/2019 0:00,31501,90556,60152,30404,54947,189792,335295,352789344,416,30157,1000,45534,7607,3252
10/20/2019 0:00,28019,93147,59929,33218,54541,187593,335281,351711727.3,415,29927,999,45481,7600,3250
10/19/2019 0:00,30906,91050,59936,31114,54175,187214,332439,350348634.3,421,39517,1008,45452,7600,3249
10/18/2019 0:00,31271,90821,60062,30759,54165,187088,332074,348531841.4,416,39496,1009,45419,7598,3249
10/17/2019 0:00,30757,90914,58323,32591,53839,186261,331014,346736486.1,405,40731,694,45335,7592,3192
10/16/2019 0:00,30733,92602,59673,32929,52719,184661,329982,345421043.8,412,40048,718,45266,7588,3189
10/15/2019 0:00,31144,91900,60279,31621,52436,183563,327899,344233374.7,462,39648,724,45167,7575,3181
10/14/2019 0:00,26292,92017,59969,32048,52265,183171,327453,343116452.1,469,39076,722,45096,7566,3175
10/13/2019 0:00,26336,94842,59975,34867,50980,181460,327282,341938890.5,469,39129,718,45061,7563,3170
10/12/2019 0:00,24075,94860,59990,34870,50971,181451,327282,340423857.1,463,39528,671,45053,7562,3168
10/11/2019 0:00,24419,94142,59989,34153,50956,181439,326537,338463716.6,474,39556,668,45022,7561,3165
10/10/2019 0:00,24534,96414,61890,34524,50607,179048,326069,336616917.2,559,39151,683,44940,7546,3161
10/9/2019 0:00,26197,93663,62042,31621,50517,178242,322422,335236180.2,571,38630,673,44914,7545,3153
10/8/2019 0:00,26541,93886,62416,31470,50377,177286,321549,334086470.6,737,38203,676,44846,7536,3145
10/7/2019 0:00,26599,95476,63196,32280,49687,176015,321178,332948058.7,743,37895,760,44772,7532,3141
10/6/2019 0:00,27030,95118,60545,34573,49449,175774,320341,331877727.7,745,37406,791,44717,7511,3141
10/5/2019 0:00,27574,95795,60509,35286,48285,175774,319854,330568178.4,757,37495,797,44686,7505,3141
10/4/2019 0:00,27042,95561,60509,35052,48255,175774,319590,328769023.3,757,37769,766,44635,7501,3140
10/3/2019 0:00,27467,94665,60795,33870,48194,174739,317598,326957697.3,750,37345,671,44545,7492,3145
10/2/2019 0:00,30463,90891,59566,31325,47913,173760,312564,325642393.9,755,36690,864,44569,7491,3127
10/1/2019 0:00,30507,90309,59911,30398,47762,172975,311046,324495936.8,751,36132,898,44495,7480,3126
9/30/2019 0:00,31474,89926,59795,30131,47356,171957,309239,323287684.3,744,35952,971,44434,7361,3099
9/29/2019 0:00,31228,91318,60269,31049,46909,170306,308533,321905484.2,624,35967,1014,44282,7331,3076
9/28/2019 0:00,28800,91384,58985,32399,46852,170296,308532,320631620.7,619,36197,1011,44276,7326,3075
9/27/2019 0:00,28934,91419,58987,32432,46817,170296,308532,318938948.1,622,36723,1044,44232,7317,3063
9/26/2019 0:00,28828,90902,57849,33053,46716,169794,307412,317275829,643,37029,1195,44069,7309,3064
9/25/2019 0:00,31172,90555,58183,32372,46364,167801,304720,316028634.4,620,36653,1383,43907,7298,3048
9/24/2019 0:00,28938,89289,57613,31676,45837,167640,302766,314884360.6,621,36337,1324,43813,7297,3048
9/23/2019 0:00,31645,88691,58255,30436,45588,166117,300396,313591152.5,616,36142,1359,43708,7251,3048
9/22/2019 0:00,33544,90164,59870,30294,45445,162935,298544,312136871.9,612,35886,1386,43592,7248,3045
9/21/2019 0:00,30626,90563,56500,34063,45065,162916,298544,310730565.5,600,35964,1356,43544,7245,3045
9/20/2019 0:00,30660,90458,56564,33894,44938,162854,298250,308829481.3,584,35825,1377,43510,7234,3045
9/19/2019 0:00,30302,92088,57027,35061,43554,161473,297115,306789626.8,601,35237,1354,43447,7225,3043
9/18/2019 0:00,31105,91065,58729,32336,43388,159335,293788,305246034.5,618,34519,1354,43353,7208,3031
9/17/2019 0:00,31772,90570,58027,32543,43229,158454,292253,303908799.7,640,33840,1337,43248,7189,3029
9/16/2019 0:00,34990,89958,57383,32575,43121,157857,290936,302621764.6,656,33772,1374,43169,7173,3026
9/15/2019 0:00,35699,89165,56443,32722,42630,156346,288141,301349535,693,33713,1049,43118,7171,2979
9/14/2019 0:00,33394,89458,56617,32841,42511,156172,288141,299960018.8,692,33824,993,43095,7171,2979
9/13/2019 0:00,31206,88848,56618,32230,42484,156172,287504,297925739.1,693,33977,992,43060,7166,2979
9/12/2019 0:00,29797,90033,58078,31955,42436,154714,287183,295967323.1,686,33456,919,42988,7157,2976
9/11/2019 0:00,30801,88712,57967,30745,41877,154021,284610,294441196.2,689,32942,588,42902,7147,2978
9/10/2019 0:00,31224,88712,58232,30480,41814,153262,283788,293064138.7,674,32554,504,42853,7133,2952
9/9/2019 0:00,33117,89199,58301,30898,41238,151362,281799,291832979.7,662,32494,530,42757,7123,2951
9/8/2019 0:00,31588,90988,59837,31151,40483,149574,281045,290394628.9,651,32421,525,42693,7097,2948
9/7/2019 0:00,31765,88748,60401,28347,40431,149088,278267,289049883.2,648,32588,510,42681,7095,2948
9/6/2019 0:00,31132,88754,60401,28353,40425,149088,278267,287202011.4,648,32682,498,42650,7088,2949
9/5/2019 0:00,30660,89476,61063,28413,40394,147661,277531,285323139.3,631,32427,524,42549,7077,2942
9/4/2019 0:00,30212,89755,62257,27498,40233,146183,276171,283768256.9,653,31791,548,42616,7072,2939
9/3/2019 0:00,30967,89189,62349,26840,39282,145522,273993,282395229.3,665,31229,584,42491,7054,2941
9/2/2019 0:00,30195,89142,60421,28721,39139,145442,273723,280849580.5,654,30845,577,42392,7023,2941
9/1/2019 0:00,29661,89655,60085,29570,38907,144902,273464,279780135,656,30802,566,42359,7012,2939
8/31/2019 0:00,29750,91134,61605,29529,38892,143383,273409,278057632,521,30772,569,42346,7011,2935
8/30/2019 0:00,29784,91046,61605,29441,38860,143383,273289,276103223.5,523,30687,571,42329,7008,2924
8/29/2019 0:00,28719,91502,61394,30108,38695,142337,272534,274027066,517,30229,540,42250,6977,2916
8/28/2019 0:00,27688,90744,61895,28849,38228,141138,270110,272408654.7,506,30044,535,42107,6963,2903
8/27/2019 0:00,30712,91798,63672,28126,38055,139350,269203,270995294.5,499,29979,647,42020,6954,2895
8/26/2019 0:00,30325,93076,60991,32085,37680,137963,268719,269746590.7,490,29444,621,41976,6952,2901
8/25/2019 0:00,36039,92741,59851,32890,37577,135881,266199,268423534.8,480,29586,767,41909,6934,2898
8/24/2019 0:00,35625,92144,59098,33046,37523,135863,265530,266844380.3,474,29721,755,41899,6934,2898
8/23/2019 0:00,36063,91865,57971,33894,37495,135863,265223,264902916.8,475,29949,766,41877,6931,2898
8/22/2019 0:00,32814,90493,57931,32562,37398,134426,262317,262967089.6,488,29684,743,41225,6830,2898
8/21/2019 0:00,31716,89844,56151,33693,37237,133077,260158,261423780,502,28982,731,41147,6734,2879
8/20/2019 0:00,32648,92015,59408,32607,37094,129565,258674,259980147.2,515,28315,718,41062,6722,2859
8/19/2019 0:00,32525,93016,60185,32831,36281,128798,258095,258652708.6,545,28358,731,41015,6710,2856
8/18/2019 0:00,31539,93831,58281,35550,36145,127848,257824,257249153.7,568,28145,704,40935,6695,2852
8/17/2019 0:00,31398,93808,55491,38317,36066,127848,257722,255693111.8,570,28168,709,40926,6695,2852
8/16/2019 0:00,31999,92950,55640,37310,35997,127848,256795,253679905.1,574,28168,718,40910,6691,2851
8/15/2019 0:00,31549,92643,53831,38812,35753,127151,255547,251919972.9,589,27548,714,40845,6677,2848
8/14/2019 0:00,30923,91115,54382,36733,35662,126177,252954,250384871.1,590,26995,688,38987,6410,2828
8/13/2019 0:00,32082,90757,54831,35926,35585,124335,250677,248985101.6,563,26402,701,38906,6374,2831
8/12/2019 0:00,32854,89434,53574,35860,35459,124335,249228,247563973.6,572,25663,723,38820,6352,2796
8/11/2019 0:00,32493,90007,53408,36599,35164,123697,248868,246368611.8,577,25452,709,38775,6331,2791
8/10/2019 0:00,32545,89276,52644,36632,35147,123697,248120,244802319.6,577,25417,709,38761,6330,2791
8/9/2019 0:00,30762,89683,52644,37039,34558,123697,247938,242747916,590,25428,711,38740,6314,2791
8/8/2019 0:00,30134,89895,52412,37483,34432,122934,247261,241059746.8,651,25135,698,38689,6288,2784
8/7/2019 0:00,29892,91090,54665,36425,33810,121073,245973,239553154.2,638,24421,672,38602,6286,2775
8/6/2019 0:00,30597,91026,54170,36856,33609,120416,245051,238247034.5,634,24081,707,38421,6260,2771
8/5/2019 0:00,29035,91312,54795,36517,33333,119819,244464,236930559.1,635,30633,659,38348,6247,2713
8/4/2019 0:00,28090,91885,55321,36564,33200,118686,243771,235662638,508,30374,668,38272,6244,2700
8/3/2019 0:00,29273,91239,54404,36835,33067,118686,242992,234222762.8,509,30418,681,38265,6244,2700
8/2/2019 0:00,28848,91353,54422,36931,32939,118686,242978,232311310.3,509,30432,675,38236,6241,2700
8/1/2019 0:00,29460,91520,54741,36779,32716,117634,241870,230397325.7,502,30189,669,38159,6230,2689
7/31/2019 0:00,25205,92357,55351,37006,32688,116240,241285,228810428.8,494,29601,668,38042,6220,2692
7/30/2019 0:00,27036,89545,55026,34519,32637,115739,237921,227485040.3,483,29123,687,37966,6199,2680
7/29/2019 0:00,28286,87381,55743,31638,31516,114756,233653,226267749.9,491,29310,611,37882,6189,2643
7/28/2019 0:00,29615,87437,54201,33236,31054,113159,231650,225087135.3,487,29046,625,37813,6154,2635
7/27/2019 0:00,28235,87306,53861,33445,30945,113094,231345,223648706.5,487,29160,612,37793,6153,2537
7/26/2019 0:00,27845,87308,53861,33447,30943,113094,231345,221842109.9,490,29573,598,37776,6149,2526
7/25/2019 0:00,27778,85924,52897,33027,30770,112230,228924,220050702.9,505,29103,577,37684,6134,2502
7/24/2019 0:00,25887,86350,53873,32477,30682,110752,227784,218658146.8,519,28477,586,34682,5977,2499
7/23/2019 0:00,23518,87304,53553,33751,30569,109586,227459,217333914.3,522,27889,543,34564,5959,2488
7/22/2019 0:00,22663,88602,53866,34736,30111,108058,226771,216021510.4,546,27510,608,34493,5901,2460
7/21/2019 0:00,23975,88172,52379,35793,30011,107138,225321,214756530.5,541,27323,646,34343,5885,2449
7/20/2019 0:00,24519,87378,52404,34974,29983,107138,224499,213314480.3,541,27449,654,34318,5879,2449
7/19/2019 0:00,24842,87106,52113,34993,29963,107138,224207,211706062.5,541,27534,696,34293,5877,2449
7/18/2019 0:00,25745,86750,52441,34309,29848,106015,222613,209928623.2,535,27082,701,34239,5859,2448
7/17/2019 0:00,20545,87708,53071,34637,29300,105047,222055,208464320.5,539,26810,645,34118,5856,2442
7/16/2019 0:00,23200,84663,52679,31984,29109,104638,218410,207248023.8,546,26424,669,34029,5851,2441
7/15/2019 0:00,25823,84368,52710,31658,27592,102975,214935,206016085.3,533,26462,708,33964,5725,2436
7/14/2019 0:00,25393,85770,52290,33480,27247,101892,214909,204833722,526,26807,699,33855,5723,2436
7/13/2019 0:00,24969,86720,52024,34696,26006,101892,214618,203523975,526,26943,697,33718,5718,2436
7/12/2019 0:00,25656,85865,52024,33841,25961,101892,213718,201596868.7,528,27049,695,33699,5716,2435
7/11/2019 0:00,26076,86441,51837,34604,25831,100621,212893,199724655,518,27046,709,33613,5693,2433
7/10/2019 0:00,25502,86594,47380,39214,25592,99681,211867,198194950.3,519,26462,685,33543,5684,2431
7/9/2019 0:00,24785,88905,49409,39496,25263,97363,211531,196867822.9,507,25933,694,33459,5651,2419
7/8/2019 0:00,24843,88917,47522,41395,25164,96971,211052,195570573.1,511,25374,694,33364,5624,2419
7/7/2019 0:00,31466,87430,50334,37096,24860,92786,205076,194291134.1,366,25030,777,33278,5612,2357
7/6/2019 0:00,30800,87451,48814,38637,24694,92786,204931,192829165.2,369,24995,782,33262,5611,2357
7/5/2019 0:00,31388,86438,48564,37874,24677,92786,203901,191030505.6,369,25197,763,33243,5611,2357
7/4/2019 0:00,31648,85663,47305,38358,24368,92779,202810,189108951.6,367,25037,759,33194,5602,2357
7/3/2019 0:00,30861,85976,47294,38682,24080,92694,202750,188204320.2,366,26798,756,33165,5588,2357
7/2/2019 0:00,31897,84392,46839,37553,23737,92405,200534,186450296,377,26388,764,33113,5532,2281
7/1/2019 0:00,35926,81598,46795,34803,23647,91097,196342,185018278.9,384,25645,775,33046,5523,2278
6/30/2019 0:00,35915,81249,46089,35160,23305,90989,195543,183647791.4,409,25400,647,32980,5517,2295
6/29/2019 0:00,35556,81608,45856,35752,22662,90989,195259,182179823.7,409,26889,649,32973,5516,2295
6/28/2019 0:00,35321,81592,45436,36156,22662,90989,195243,180262726.1,419,27515,642,32952,5512,2298
6/27/2019 0:00,34020,82735,45544,37191,22234,90056,195025,178495215.8,450,26961,613,32907,5505,2263
6/26/2019 0:00,28622,83647,46882,36765,21914,88724,194285,177066209.3,487,26444,555,32852,5502,2254
6/25/2019 0:00,27453,84014,46338,37676,21754,87930,193698,175808752.4,491,27153,559,32800,5495,2262
6/24/2019 0:00,26782,83476,47249,36227,21498,87018,191992,174526619.9,488,26965,472,32726,5480,2243
6/23/2019 0:00,25188,85528,47792,37736,21162,85302,191992,173395869.2,498,26542,449,32691,5478,2086
6/22/2019 0:00,24969,85539,47370,38169,21151,85302,191992,172014494.9,498,26598,434,32688,5477,2086
6/21/2019 0:00,24989,85502,47041,38461,21101,85229,191832,170270394,490,26619,438,32676,5475,2086
6/20/2019 0:00,26637,82685,46802,35883,20955,85088,188728,168483987.2,494,26297,485,32561,5454,2075
6/19/2019 0:00,25965,81725,47294,34431,20913,84303,186941,166958491.2,489,26016,458,32487,5439,2069
6/18/2019 0:00,25488,81204,47424,33780,20569,83603,185376,165819303.2,494,25609,453,32406,5427,2046
6/17/2019 0:00,26420,81037,48333,32704,19530,82743,183310,164607643,487,25277,455,32323,5414,2045
6/16/2019 0:00,26831,81793,45428,36365,19273,81773,182839,163338031,493,24912,469,32274,5408,2039
6/15/2019 0:00,26204,81821,45084,36737,19245,81773,182839,162027764.4,501,24918,478,32262,5406,2039
6/14/2019 0:00,26616,81423,45084,36339,19242,81773,182438,160423774.5,501,25098,482,32248,5406,2039
6/13/2019 0:00,28044,81798,46949,34849,19001,79374,180173,158753470.3,487,24894,480,32179,5391,2025
6/12/2019 0:00,24818,82574,48122,34452,18575,78314,179463,157405905.4,444,24313,449,32149,5389,2025
6/11/2019 0:00,27525,79745,47708,32037,18464,78120,176329,156274310.2,444,23965,478,32067,5388,2017
6/10/2019 0:00,28291,80126,47584,32542,17451,77555,175132,155111827.2,443,23916,485,31962,5382,2011
6/9/2019 0:00,26089,82404,49313,33091,17352,75376,175132,153963680.2,306,23531,459,31925,5375,2004
6/8/2019 0:00,27405,81839,49077,32762,17278,75252,174369,152730749.6,300,23574,490,31908,5363,2003
6/7/2019 0:00,29279,79984,48785,31199,17259,75252,172495,151189384.4,300,23690,498,31896,5357,2003
6/6/2019 0:00,28922,79855,49700,30155,16885,74243,170983,149599882.5,297,23317,492,31821,5332,1982
6/5/2019 0:00,29991,78615,47963,30652,16684,73368,168667,148330449.3,312,22891,509,31735,5325,1979
6/4/2019 0:00,29188,78240,47776,30464,16392,72178,166810,147209485.5,306,22715,498,31661,5319,1976
6/3/2019 0:00,28240,78508,42239,36269,16346,71572,166426,145684687.7,300,22396,445,31562,5277,1976
6/2/2019 0:00,29815,79286,44318,34968,16246,68936,164468,144708160.8,324,22029,466,31492,5250,1976
6/1/2019 0:00,29753,78593,44023,34570,16111,68936,163640,143600880.3,324,22066,478,31489,5250,1976
5/31/2019 0:00,27976,78332,43779,34553,16091,68936,163359,142192652.8,328,22034,470,31437,5246,1976
5/30/2019 0:00,26461,78633,42905,35728,15984,68436,163053,140767147.8,345,21585,439,31312,5192,1974
5/29/2019 0:00,24816,79083,39155,39928,15663,67358,162104,139570534.1,368,21015,414,31252,5182,1962
5/28/2019 0:00,26905,78424,40166,38258,15369,65467,159260,138452015.5,381,20571,421,31189,5182,1961
5/27/2019 0:00,27461,79207,40882,38325,15147,64677,159031,137382403.9,392,20338,432,31137,5177,1961
5/26/2019 0:00,30464,77222,40569,36653,15071,64677,156970,136548968.2,392,20393,473,31135,5177,1960
5/25/2019 0:00,30234,77128,40281,36847,14994,64677,156799,135250228.2,393,20458,475,31131,5177,1957
5/24/2019 0:00,29962,76653,39692,36961,14979,64677,156309,133597430.9,400,20598,468,31110,5168,1951
5/23/2019 0:00,26948,77200,40167,37033,14857,64119,156176,131875941.8,397,20490,461,31060,5163,1945
5/22/2019 0:00,27051,77923,40749,37174,14706,63107,155736,130571834.1,385,19984,447,31021,5157,1942
5/21/2019 0:00,28268,76775,42554,34221,14681,61294,152750,129476081.4,366,19667,459,30984,5150,1940
5/20/2019 0:00,28308,78322,44188,34134,14642,59360,152324,128481235.8,352,19500,465,30871,5113,1940
5/19/2019 0:00,29901,77072,44981,32091,14323,58568,149963,127514036.1,369,19218,473,30844,5112,1934
5/18/2019 0:00,29238,76821,44738,32083,14264,58568,149653,126317866.9,369,19256,463,30841,5112,1934
5/17/2019 0:00,28814,76694,44423,32271,14252,58568,149514,124807101.1,369,19415,455,30830,5111,1934
5/16/2019 0:00,29241,76556,44523,32033,14062,58010,148628,123278242.2,363,19116,471,30768,5103,1937
5/15/2019 0:00,31030,76803,45820,30983,13791,55400,145994,122068236.2,336,18819,476,30732,5093,1938
5/14/2019 0:00,28744,77183,46014,31169,13730,54343,145256,120970219,323,18482,479,30671,5093,1930
5/13/2019 0:00,31145,76627,47453,29174,13653,52909,143189,119974377.4,308,18171,523,30623,5091,1932
5/12/2019 0:00,30704,78322,47995,30327,13377,51407,143106,119033580.7,186,17806,522,30597,5090,1924
5/11/2019 0:00,30124,78328,47760,30568,13344,51407,143079,118047164.5,187,17859,505,30592,5089,1924
5/10/2019 0:00,29500,78528,47446,31082,12948,51407,142883,116654512.6,187,17794,489,30557,5079,1922
5/9/2019 0:00,29676,78609,47217,31392,12913,50336,141858,115214566.4,195,17782,490,30469,5063,1922
5/8/2019 0:00,31501,75472,47238,28234,12677,49447,137596,114159543.8,191,17872,510,28182,4351,1914
5/7/2019 0:00,30005,74822,47524,27298,12609,49167,136598,113169984.2,205,17686,507,28136,4264,1907
5/6/2019 0:00,29309,74548,46917,27631,12511,48806,135865,112251606.6,201,17589,505,28069,4264,1908
5/5/2019 0:00,29929,76743,48660,28083,12231,46338,135312,111368774.9,202,17407,517,28038,4258,1904
5/4/2019 0:00,30023,76837,47876,28961,12135,46338,135310,110193898.1,202,17409,516,28038,4258,1903
5/3/2019 0:00,30638,76067,47595,28472,12019,46338,134424,108714578.8,211,18081,531,28028,4255,1903
5/2/2019 0:00,20500,77644,47723,29921,11426,45145,134215,107391854.2,217,18291,474,27945,4245,1901
5/1/2019 0:00,20986,78062,47765,30297,11267,44199,133528,106358555,232,18085,459,27883,4241,1871
4/30/2019 0:00,21313,77548,46515,31033,11220,43428,132196,105389448.8,252,17862,427,27828,4236,1863
4/29/2019 0:00,23633,75379,46840,28539,10810,42709,128898,104509463.2,262,18089,453,27729,4218,1862
4/28/2019 0:00,26178,74191,46592,27599,10748,42301,127240,103694812.4,270,17851,488,27654,4215,1851
4/27/2019 0:00,25293,74015,44056,29959,10668,42301,126984,102628810.1,272,17821,495,27651,4215,1851
4/26/2019 0:00,24047,73421,43744,29677,10642,42301,126364,101201995.1,279,17796,489,27562,4211,1851
4/25/2019 0:00,24083,72983,44361,28622,10268,41118,124369,99699130.3,268,18219,464,26038,4206,1848
4/24/2019 0:00,23267,73932,44518,29414,10041,40351,124324,98777189.26,287,18120,433,25961,4203,1847
4/23/2019 0:00,26183,72926,45080,27846,9855,38379,121160,97827247.19,280,17941,473,25829,4191,1839
4/22/2019 0:00,26399,70662,45441,25221,9833,37406,117901,96906986.56,272,17265,456,25707,4127,1831
4/21/2019 0:00,27000,70505,45570,24935,9830,36733,117068,95999732.09,276,16743,466,25639,3673,1832
4/20/2019 0:00,27530,70302,45570,24732,9769,36733,116804,95372959.67,276,16732,469,25636,3672,1832
4/19/2019 0:00,27585,70644,46030,24614,9754,35821,116219,93790121.68,278,17044,488,25625,3669,1830
4/18/2019 0:00,27948,68740,45166,23574,9495,34750,112985,92188987.13,300,16974,516,25575,3664,1837
4/17/2019 0:00,27045,68420,44194,24226,9363,34750,112533,91076003.12,302,16574,530,25479,3599,1830
4/16/2019 0:00,29140,65857,42683,23174,9290,34323,109470,90084628.76,310,16064,547,24757,3548,1761
4/15/2019 0:00,30401,64975,41713,23262,8997,34050,108022,89196984.35,311,15634,571,24653,3628,1743
4/14/2019 0:00,30404,66136,40349,25787,8954,32721,107811,88412022.32,184,15159,566,24610,3604,1736
4/13/2019 0:00,29639,66256,40353,25903,8834,32721,107811,87428581.21,184,15152,560,24608,3604,1736
4/12/2019 0:00,29131,66507,40585,25922,8694,32243,107444,86098480.74,176,15153,535,24589,3604,1736
4/11/2019 0:00,24912,65170,40229,24941,8650,31266,105086,84868347.48,181,14944,480,24420,3551,1732
4/10/2019 0:00,23709,64522,40706,23816,8574,30512,103608,83899490.79,165,14654,475,24344,3548,1747
4/9/2019 0:00,25044,62343,39987,22356,8385,30234,100962,83019235.35,168,14454,466,24280,3538,1744
4/8/2019 0:00,26238,62806,39947,22859,7746,29397,99949,82249705,164,14186,476,21454,3523,1729
4/7/2019 0:00,27023,63674,40838,22836,7395,27991,99060,81448285.53,148,13841,481,21376,3508,1728
4/6/2019 0:00,26766,63701,40601,23100,7357,27991,99049,80466283.04,149,13837,476,21367,3507,1728
4/5/2019 0:00,20097,62464,40265,22199,7327,27991,97782,79182616.2,149,13815,340,21355,3505,1714
4/4/2019 0:00,25999,62595,40545,22050,7292,27384,97271,77476245.32,141,13346,477,21229,3493,1703
4/3/2019 0:00,24846,63081,40807,22274,7231,26823,97135,77060270.46,139,12918,451,20941,3415,1685
4/2/2019 0:00,22693,63136,41039,22097,7095,26289,96520,76183910.81,138,12746,434,20579,3409,1685
4/1/2019 0:00,22996,62133,40436,21697,6970,25633,94736,75404747.59,140,12483,438,20510,3405,1679
3/31/2019 0:00,22861,61470,39439,22031,6932,25633,94035,74617570.38,145,12267,436,20425,3403,1669
3/30/2019 0:00,21584,61410,39440,21970,6894,25633,93937,73692136.61,146,12291,421,20409,3362,1668
3/29/2019 0:00,15292,60481,38515,21966,6889,25633,93003,72438158,146,12047,292,20388,3360,1667
3/28/2019 0:00,15894,57004,37917,19087,6834,25161,88999,71270026.99,145,11596,305,20346,3283,1662
3/27/2019 0:00,16078,53713,35821,17892,6771,25066,85550,70362719.28,122,11028,298,20023,3254,1609
3/26/2019 0:00,15399,53334,36291,17043,6624,24344,84302,69370147.92,125,10462,277,19865,3232,1593
3/25/2019 0:00,16757,49199,32364,16835,6555,24305,80059,68650484.51,124,10247,313,19723,3155,1570
3/24/2019 0:00,15941,45625,31082,14543,6519,22018,74162,67904980.32,115,9963,371,19681,3145,1515
3/23/2019 0:00,16718,45205,30805,14400,6432,22018,73655,66988779.32,116,9948,385,19673,3138,1515
3/22/2019 0:00,16054,45166,30477,14689,6369,22018,73553,65788918.49,116,9879,380,15426,3124,1506
3/21/2019 0:00,15029,43514,28981,14533,6318,21361,71193,64762517.07,110,10037,313,15393,3110,1503
3/20/2019 0:00,14182,42654,24927,17727,6262,20887,69803,64046856.18,105,9757,300,15277,3096,1479
3/19/2019 0:00,12727,39501,24476,15025,6255,20586,66342,63380555.75,107,9445,239,14507,2926,1459
3/18/2019 0:00,13944,37464,23776,13688,6181,20486,64131,62803210.66,109,8597,261,14421,2829,1443
3/17/2019 0:00,14404,38532,24526,14006,6174,18998,63704,62221880.21,91,8814,258,14276,2822,1436
3/16/2019 0:00,13812,38457,24528,13929,6164,18998,63619,61509739.27,91,8821,249,14274,2822,1436
3/15/2019 0:00,12871,38297,24239,14058,6156,18998,63451,60524852.72,91,8721,243,14260,2817,1436
3/14/2019 0:00,12846,38120,24240,13880,6077,18998,63195,59648895.26,92,8245,224,14085,2769,1437
3/13/2019 0:00,13615,37583,23032,14551,6055,18639,62277,58980630.68,91,7920,225,13672,2693,1437
3/12/2019 0:00,15242,36485,23625,12860,6016,18052,60553,58389516.94,96,7601,256,13643,2689,1437
3/11/2019 0:00,14883,36369,22522,13847,5958,17610,59937,57824986.19,92,7477,258,13603,2686,1441
3/10/2019 0:00,15849,36468,23025,13443,5766,16876,59110,57260932.82,85,7489,282,13372,2674,1337
3/9/2019 0:00,15163,36316,23027,13289,5752,16876,58944,56694233.66,85,7503,281,13369,2673,1336
3/8/2019 0:00,12672,34292,22378,11914,5745,16876,56913,55706840.39,85,7467,211,13353,2670,1336
3/7/2019 0:00,12383,30918,19027,11891,5737,16369,53024,54861218.08,79,7241,205,11037,2545,1218
3/6/2019 0:00,11893,31205,19280,11925,5695,16122,53022,54175499.55,77,7091,202,11004,2538,1202
3/5/2019 0:00,13415,28925,17806,11119,5688,16122,50735,53558445.86,80,6869,186,10953,2537,1198
3/4/2019 0:00,13499,29634,18561,11073,5668,15372,50674,53011495.21,72,6783,187,10915,2538,1165
3/3/2019 0:00,13712,30921,15459,15462,5624,13870,50415,52603901.87,61,6826,194,10903,2531,1155
3/2/2019 0:00,13644,30865,15459,15406,5588,13870,50323,51910482.84,61,6812,191,10903,2531,1152
3/1/2019 0:00,13647,30728,15248,15480,5585,13870,50183,51158789.54,65,6765,208,10882,2520,1152
2/28/2019 0:00,12918,31115,13967,17148,5312,13575,50002,50255373.97,74,6491,206,10839,2517,1149
2/27/2019 0:00,11921,30818,13654,17164,5305,13575,49698,49671267.63,77,6284,200,10812,2517,1148
2/26/2019 0:00,9477,31075,12123,18952,5070,13359,49504,48898172.01,80,6180,202,10724,2458,1136
2/25/2019 0:00,7508,28463,12184,16279,5006,13298,46767,48583037.34,92,6057,183,10651,2451,1131
2/24/2019 0:00,7808,27898,12539,15359,5006,12943,45847,48099683.81,93,5989,189,10626,2440,1129
2/23/2019 0:00,7237,27903,12334,15569,5001,12943,45847,47492513.97,93,5986,181,10621,2437,1128
2/22/2019 0:00,8118,27036,11755,15281,4999,12943,44978,46582315.95,93,6052,199,10602,2429,1124
2/21/2019 0:00,7901,27284,11946,15338,4939,12752,44975,45776396.72,97,6437,192,10598,2424,1117
2/20/2019 0:00,8246,27743,12649,15094,4900,12046,44689,45214366.79,88,6312,201,10582,2283,1116
2/19/2019 0:00,8086,27860,12986,14874,4832,11439,44131,44674558.2,87,6082,200,10559,2269,1105
2/18/2019 0:00,9268,27033,13207,13826,4541,10936,42510,44116920.45,85,5972,192,10410,2138,964
2/17/2019 0:00,9213,26811,13208,13603,4522,10936,42269,43580220.82,85,5915,189,10352,2117,958
2/16/2019 0:00,8846,26818,13208,13610,4515,10936,42269,42808558.52,85,5924,161,10336,2115,958
2/15/2019 0:00,9133,26339,12897,13442,4494,10936,41769,41859208.3,85,5898,169,9599,2113,958
2/14/2019 0:00,8527,26235,12982,13253,4425,10851,41511,41000501.88,96,5712,177,9559,2107,925
2/13/2019 0:00,7353,26813,13294,13519,4419,10279,41511,40360965.04,100,5527,180,9139,2050,922
2/12/2019 0:00,7462,26645,13294,13351,4400,10279,41324,39812916.54,102,5424,182,9009,1997,920
2/11/2019 0:00,7426,26609,11270,15339,4387,10279,41275,39482807.06,102,5280,181,8944,1986,920
2/10/2019 0:00,7548,26506,11273,15233,4376,10279,41161,38917296.17,105,5201,197,8907,1981,918
2/9/2019 0:00,7648,25899,11273,14626,4355,10279,40533,38256160.77,105,5637,195,8902,1981,918
2/8/2019 0:00,7964,25536,11273,14263,4354,10279,40169,36681368.77,105,5635,203,8887,1974,918
2/7/2019 0:00,7682,25888,11601,14287,4330,9951,40169,35976314.62,95,5538,195,8874,1956,916
2/6/2019 0:00,7541,25990,11875,14115,4251,9677,39918,35461006.91,99,6393,191,8779,1954,908
2/5/2019 0:00,7476,26028,11521,14507,4192,9533,39753,35004332.09,97,6209,183,8731,1888,907
2/4/2019 0:00,7845,25622,11805,13817,4183,9250,39055,34542563.59,101,6178,184,8714,1885,893
2/3/2019 0:00,7993,25862,12325,13537,4175,8731,38768,34063669.14,97,5938,190,8689,1884,873
2/2/2019 0:00,6614,25261,11076,14185,4168,8731,38160,33544359.26,97,5944,178,8675,1884,873
2/1/2019 0:00,6452,25245,10579,14666,4165,8731,38141,32764996.97,97,5872,180,8667,1882,873
1/31/2019 0:00,6531,25392,10739,14653,4138,8571,38101,32064770.39,103,5692,178,8630,1865,873
1/30/2019 0:00,6419,25548,11050,14498,4116,8260,37924,31563270.11,103,5610,176,8562,1835,712
1/29/2019 0:00,6566,25597,12174,13423,3027,7810,36434,31077211.45,104,5517,179,8452,1808,675
1/28/2019 0:00,6820,25307,13045,12262,2212,7196,34715,30656876.71,106,5665,177,8198,1808,675
1/27/2019 0:00,7754,25071,13367,11704,2147,6576,33794,30106489.6,103,5545,185,8121,1699,664
1/26/2019 0:00,8140,24789,13472,11317,2135,6496,33420,29442257.37,102,5521,188,8118,1699,664
1/25/2019 0:00,8141,24793,13472,11321,2131,6496,33420,28602715.3,102,5385,188,8109,1699,664
1/24/2019 0:00,7193,24710,13430,11280,2120,6496,33326,27836324.26,106,5246,159,8009,1565,664
1/23/2019 0:00,7227,22433,12146,10287,2115,6362,30910,27290294.13,114,5138,157,7956,1532,664
1/22/2019 0:00,7088,22294,12226,10068,2094,6003,30391,26732777.62,110,4949,149,7902,1527,658
1/21/2019 0:00,7304,22405,12731,9674,2091,5500,29996,26236657.17,97,4882,154,7876,1498,655
1/20/2019 0:00,7513,22488,12879,9609,2043,5264,29795,25725235.95,86,6427,156,7829,1493,621
1/19/2019 0:00,7517,22507,12641,9866,2024,5264,29795,25579649.76,86,6407,156,7814,1493,621
1/18/2019 0:00,7803,22230,12357,9873,2020,5264,29514,24839214.31,87,6337,164,7711,1488,621
1/17/2019 0:00,9356,22232,12823,9409,1999,4781,29012,24180273.66,82,6185,185,7610,1435,553
1/16/2019 0:00,9492,21879,12835,9044,1978,4781,28638,23611659.41,84,6017,177,7558,1428,553
1/15/2019 0:00,8842,21960,12904,9056,1897,4781,28638,23101277.03,84,5902,161,7546,1428,535
1/14/2019 0:00,8678,22022,12786,9236,1895,4691,28608,22629793.19,88,5363,151,7516,1418,519
1/13/2019 0:00,8944,22051,13168,8883,1892,4309,28252,22168613.4,83,5190,156,7505,1417,504
1/12/2019 0:00,8956,22061,13168,8893,1882,4309,28252,21687244.72,83,5163,156,7501,1417,504
1/11/2019 0:00,8896,22062,13168,8894,1881,4309,28252,21023853.53,83,5111,153,7493,1413,505
1/10/2019 0:00,3019,16082,8928,7154,1875,4309,22266,20401914.59,84,4848,106,7353,1335,505
1/9/2019 0:00,3163,15967,8433,7534,1756,4263,21986,19962377.87,83,4666,107,7302,1316,494
1/8/2019 0:00,2960,15970,8593,7377,1669,4120,21759,19579097.86,81,4446,101,7247,1299,492
1/7/2019 0:00,3107,15558,7828,7730,1638,4096,21292,19232625.23,73,4307,107,7214,1298,492
1/6/2019 0:00,3217,15613,7637,7976,1605,3967,21185,18865637.64,73,4119,110,7191,1296,492
1/5/2019 0:00,2781,15557,7204,8353,1595,3903,21055,18452340.06,72,4126,98,7191,1296,492
1/4/2019 0:00,2493,15688,7332,8356,1592,3775,21055,17927650.82,71,4060,90,7170,1290,492
1/3/2019 0:00,2633,15510,7438,8072,1449,3387,20346,17449005.69,64,3937,92,7161,1286,444
1/2/2019 0:00,3254,15319,7774,7545,1232,3207,19758,17042901.06,54,3815,102,7119,1285,440
1/1/2019 0:00,3288,15493,7996,7497,1217,2985,19695,16632025.77,49,3665,101,7092,1253,437
12/31/2018 0:00,4045,15414,7652,7762,1082,2799,19295,16460702.09,38,3604,123,7076,1206,437
12/30/2018 0:00,4051,15474,7686,7788,1056,2765,19295,16074857.25,36,3483,123,7024,1136,435
12/29/2018 0:00,4257,15539,7897,7642,1048,2553,19140,15601674.64,33,3475,130,7015,1135,436
12/28/2018 0:00,4401,15573,7947,7626,920,2503,18996,15061066.97,32,3363,134,7015,1135,432
12/27/2018 0:00,4613,15976,8619,7357,914,1832,18722,14490862.41,15,3207,140,6997,1129,409
12/26/2018 0:00,7685,16393,8178,8215,704,1261,18358,13912414.37,9,3285,239,6797,1126,407
12/25/2018 0:00,8145,16430,8898,7532,687,550,17667,13359897.43,4,3174,243,6774,1118,362
12/24/2018 0:00,8167,16430,8898,7532,687,550,17667,13359897.43,4,3174,243,6774,1118,362
12/23/2018 0:00,8253,17000,8712,8288,140,459,17599,13057421.03,3,3196,246,6765,1113,358
12/22/2018 0:00,8446,16858,8712,8146,138,459,17455,12579237.44,3,3196,251,6761,1111,358
12/21/2018 0:00,8690,16675,8128,8547,109,459,17243,11941619.33,3,3133,258,6760,1111,358
12/20/2018 0:00,8511,15754,8131,7623,86,459,16299,11545757.42,3,2789,260,6692,1110,358
12/19/2018 0:00,8792,15457,7665,7792,70,459,15986,11116251.89,3,2596,268,6666,1098,351
12/18/2018 0:00,7799,14291,6738,7553,68,459,14818,10722137.36,3,2463,256,6590,1098,343
12/17/2018 0:00,7702,13925,595,13330,17,459,14401,10355378.7,3,2245,252,6549,1095,342
12/16/2018 0:00,160,794,595,199,12,459,1265,9987926.85,3,1369,4,4257,984,342
12/15/2018 0:00,160,794,595,199,12,459,1265,9601912.68,3,1361,4,2418,865,330
12/14/2018 0:00,160,794,595,199,12,459,1265,9154020.63,3,1337,4,2407,865,330
12/13/2018 0:00,160,697,595,102,12,459,1168,8777269.36,3,1251,4,1459,745,330
12/12/2018 0:00,250,607,595,12,12,459,1078,8445024.17,3,1235,4,1451,741,320
12/11/2018 0:00,250,607,595,12,12,459,1078,8128446.95,3,1176,4,1414,733,320
12/10/2018 0:00,250,607,595,12,12,459,1078,7809882.87,3,1162,4,1402,730,306
12/9/2018 0:00,250,607,595,12,12,459,1078,7519411.36,3,1128,4,1398,533,283
12/8/2018 0:00,250,607,595,12,12,459,1078,7185088.82,3,1128,4,1398,533,283
12/7/2018 0:00,250,607,595,12,12,459,1078,6773398.45,3,1101,4,1389,533,283
12/6/2018 0:00,250,607,595,12,12,459,1078,6340285.72,3,1042,4,1379,533,280
12/5/2018 0:00,250,607,595,12,12,459,1078,6000431.66,6,1044,4,1317,533,180
12/4/2018 0:00,0,654,642,12,12,412,1078,5677468.71,5,1008,0,1075,467,147
12/3/2018 0:00,0,839,827,12,11,228,1078,5382566.24,3,986,0,937,395,139
12/2/2018 0:00,0,839,827,12,11,228,1078,5075717.89,3,950,0,919,315,139
12/1/2018 0:00,0,839,827,12,11,228,1078,4576756.18,3,949,0,918,315,139
11/30/2018 0:00,0,839,827,12,11,228,1078,3620367.69,3,930,0,918,315,139
11/29/2018 0:00,0,845,833,12,5,228,1078,3502209.1,3,916,0,916,312,129
11/28/2018 0:00,0,849,837,12,1,228,1078,3405597.99,3,895,0,624,312,125
11/27/2018 0:00,0,849,837,12,1,228,1078,3047567.34,3,873,0,605,117,113
11/26/2018 0:00,0,849,837,12,1,228,1078,2705429.31,3,856,0,604,116,103
11/25/2018 0:00,0,849,837,12,1,228,1078,2333056.68,3,835,0,578,116,100
11/24/2018 0:00,0,849,837,12,1,228,1078,1930150.66,3,815,0,577,116,100
11/23/2018 0:00,0,849,837,12,1,228,1078,1435854.08,3,804,0,575,115,100
11/22/2018 0:00,0,959,947,12,1,118,1078,928667.01,1,790,0,575,115,100
11/21/2018 0:00,0,959,947,12,1,118,1078,928667.01,1,790,0,575,115,100
11/20/2018 0:00,0,1077,1065,12,1,0,1078,289128.7,0,775,0,570,115,100
11/19/2018 0:00,0,1077,1065,12,1,0,1078,177,0,675,0,533,113,100
11/18/2018 0:00,0,228,217,11,0,0,228,177,0,649,0,524,112,100
11/17/2018 0:00,0,0,0,0,0,0,0,177,0,624,0,506,92,100
11/16/2018 0:00,0,0,0,0,0,0,0,177,0,613,0,506,92,100
11/15/2018 0:00,0,0,0,0,0,0,0,177,0,613,0,506,92,74
11/14/2018 0:00,0,0,0,0,0,0,0,177,0,550,0,485,92,74
11/13/2018 0:00,0,0,0,0,0,0,0,177,0,542,0,481,91,74
11/12/2018 0:00,0,0,0,0,0,0,0,177,0,542,0,481,91,74
11/9/2018 0:00,0,0,0,0,0,0,0,177,0,500,0,481,91,74
11/8/2018 0:00,0,0,0,0,0,0,0,177,0,500,0,481,91,74
11/7/2018 0:00,0,0,0,0,0,0,0,177,0,500,0,481,91,74
11/6/2018 0:00,0,0,0,0,0,0,0,147,0,496,0,481,91,74
11/5/2018 0:00,0,0,0,0,0,0,0,0,0,421,0,440,90,74
11/2/2018 0:00,0,0,0,0,0,0,0,0,0,421,0,440,90,74
11/1/2018 0:00,0,0,0,0,0,0,0,0,0,421,0,440,90,73
10/31/2018 0:00,0,0,0,0,0,0,0,0,0,421,0,424,90,73
10/30/2018 0:00,0,0,0,0,0,0,0,0,0,421,0,424,90,65
10/29/2018 0:00,0,0,0,0,0,0,0,0,0,421,0,424,90,44
10/26/2018 0:00,0,0,0,0,0,0,0,0,0,364,0,401,89,44
10/25/2018 0:00,0,0,0,0,0,0,0,0,0,364,0,314,73,44
10/24/2018 0:00,0,0,0,0,0,0,0,0,0,364,0,314,73,44
10/23/2018 0:00,0,0,0,0,0,0,0,0,0,0,0,0,0,44
10/22/2018 0:00,0,0,0,0,0,0,0,0,0,0,0,0,0,44
10/19/2018 0:00,0,0,0,0,0,0,0,0,0,0,0,0,0,44
10/18/2018 0:00,0,0,0,0,0,0,0,0,0,0,0,0,0,44
10/17/2018 0:00,0,0,0,0,0,0,0,0,0,0,0,0,0,40
10/16/2018 0:00,0,0,0,0,0,0,0,0,0,0,0,0,0,9
10/15/2018 0:00,0,0,0,0,0,0,0,0,0,0,0,0,0,3
